BXM	BATOM
ARC	ARCTIC VILLAGE
FST	FORT STOCKTON
WTK	NOATAK
PML	PORT MOLLER
ESD	EASTSOUND
RBC	ROBINVALE
SRQ	SARASOTA/BRADENTON
JIL	JILIN
SAP	SAN PEDRO SULA
AKY	SITTWE
VIN	VINNICA
VDA	OVDA
BBK	KASANE
HAE	HAVASUPAI
VER	VERA CRUZ
DPO	DEVONPORT
SUG	SURIGAO
YBG	BAGOTVILLE
ZIN	INTERLAKEN
AKR	AKURE
AHI	AMAHAI
ORN	ORAN
HND	TOKYO
BDN	BADIN
YXE	SASKATOON
KUA	KUANTAN
SGX	SONGEA
AOK	KARPATHOS
MOG	MONG HSAT
WAS	WASHINGTON
LMH	LIMON
PMV	PORLAMAR
KNG	KAIMANA
HKG	HONG KONG
JVL	JANESVILLE
BOD	BORDEAUX
GEX	GEELONG
ALE	ALPINE
SBY	SALISBURY
OAG	ORANGE
CJD	CANDILEJAS
DIO	DIOMEDE ISLAND
SIX	SINGLETON
VYD	VRYHEID
NUI	NUIQSUT
QRL	MARBELLA
PTJ	PORTLAND
USH	USHUAIA
DTM	DORTMUND
CHR	CHATEAUROUX
WGE	WALGETT
VCP	SAO PAULO
ABM	BAMAGA
TLC	TOLUCA
MZJ	PINAL AIRPARK ARPT. MARANA, AZ
HIS	HAYMAN ISLAND
VCT	VICTORIA
KCP	KAMENETS PODOLSKIY
MBE	MONBETSU
WNR	WINDORAH
APK	APATAKI
BMM	BITAM
ABZ	ABERDEEN
EYP	EL YOPAL
SNW	THANDWE
KSL	KASSALA
TDA	TRINIDAD
FAH	FARAH
HEX	SANTO DOMINGO HERRERA
YNB	YANBU
TRV	TRIVANDRUM
OZZ	OUARZAZATE
VLC	VALENCIA
YXS	PRINCE GEORGE
YOP	RAINBOW LAKE
JUJ	JUJUY
MEI	MERIDIAN
MIU	MAIDUGURI
HRA	MANSEHRA
YXP	PANGNIRTUNG
CSI	CASINO
FEA	FETLAR
KLV	KARLOVY VARY
GAQ	GAO
GME	GOMEL
RIB	RIBERALTA
WLM	WALTHAM
YFC	FREDERICTON
UBJ	UBE
BHB	BAR HARBOR
RAJ	RAJKOT
TTS	TSARATANANA
XYE	YE
GNR	GENERAL ROCA
ESM	ESMERALDAS
AIC	AIROK
BMZ	BAMU
MCT	MUSCAT
ROM	ROME
KTA	KARRATHA
PEG	PERUGIA
CZF	CAPE ROMANZOF
SDM	SAN DIEGO
LRL	LAMA-KARA
ANJ	ZANAGA
RDG	READING
MWY	MIRANDA DOWNS
YAK	YAKUTAT
IND	INDIANAPOLIS
RMB	BURAIMI
BLL	BILLUND
UCT	UKHTA
IAA	IGARKA
PNH	PHNOM-PENH
CDP	CUDDAPAH
ADM	ARDMORE
WGT	WANGARATTA
MKB	MEKAMBO
YBR	BRANDON
TSO	ISLES OF SCILLY
ATZ	ASSIUT
BWF	BARROW-IN-FURNESS
YWG	WINNIPEG
KIM	KIMBERLEY
TGR	TOUGGOURT
WJA	WOJA
FBR	FORT BRIDGER
CLO	CALI
WUN	WILUNA
DEN	DENVER
CGR	CAMPO GRANDE
DVO	DAVAO
IBR	IBARAKI
TMY	TIOM
YHH	CAMPBELL RIVER HARBOR
LFW	LOME
BSY	BARDERA
YND	GATINEAU
TPI	TAPINI
KUH	KUSHIRO
CDQ	CROYDON
MDP	MINDIPTANA
VLI	PORT VILA
LEV	LEVUKA
HAA	HASVIK
PRI	PRASLIN ISLAND
MON	MOUNT COOK
KKX	KIKAI SHIMA
LYR	LONGYEARBYEN
PUS	PUSAN
AGU	AGUASCALIENTES
MQH	MINACU
MAI	MANGOCHI
LBS	LABASA
YFO	FLIN FLON
ARI	ARICA
SDZ	SHETLAND ISLANDS
GOE	GONALIA
ASP	ALICE SPRINGS
LRV	LOS ROQUES
YQZ	QUESNEL
LBF	NORTH PLATTE
TIV	TIVAT
ORC	OROCUE
HAP	KONTIKI RESORT WHITSUNDAY
ZFL	SOUTH TROUT
PBE	PUERTO BERRIO
YKL	SCHEFFERVILLE
YGQ	GERALDTON
NKC	NOUAKCHOTT
RUH	RIYADH
NAT	NATAL
CBP	COIMBRA
IAH	HOUSTON
LAY	LADYSMITH
KYT	KYAUKTAW
ERS	WINDHOEK EROS
ELM	ELMIRA/CORNING
UII	UTILA
RTC	RATNAGIRI
HOF	HOFUF
NKU	NKAUS
MCX	MAKHACHKALA
TVY	DAWE
CCS	CARACAS
PSO	PASTO
TKT	TAK
IXQ	KAMALPUR
EGE	VAIL
GVX	GAVLE
POL	PEMBA
KTP	KINGSTON
JSU	SUKKERTOPPEN
IRK	KIRKSVILLE
GUY	GUYMON
SFE	SAN FERNANDO
PHW	PHALABORWA
SKN	STOKMARKNES
BJF	BATSFJORD
YQT	THUNDER BAY
PUE	PUERTO OBALDIA
TTD	TROUTDALE
JSO	SODERTALJE
AAC	AL ARISH
ZTB	TETE-A-LA BALEINE
LUN	LUSAKA
TIY	TIDJIKJA
LQK	PICKENS
CXY	CAT CAY
MZT	MAZATLAN
BTH	BATU BESAR
ANF	ANTOFAGASTA
OLP	OLYMPIC DAM
EAE	EMAE
YTR	TRENTON
ULA	SAN JULIAN
BRT	BATHURST ISLAND
YSE	SQUAMISH
PLX	SEMIPALATINSK
ODS	ODESSA
OGN	YONAGUNI
ARN	STOCKHOLM ARLANDA APT
TSN	TIANJIN
CUF	CUNEO
FKI	KISANGANI
DUM	DUMAI
RET	ROST
HST	HOMESTEAD
YHK	GJOA HAVEN
HOE	HOUEISAY
NHF	NEW HALFA
DEI	DENIS ISLAND
JDH	JODHPUR
YIH	YICHANG
MDS	MIDDLE CAICOS
MOL	MOLDE
VUP	VALLEDUPAR
BIR	BIRATNAGAR
HGA	HARGEISA
SHP	QINHUANGDAO
YPH	INUKJUAK
LLA	LULEA
CBX	CONDOBOLIN
VTF	VATULELE
GFK	GRAND FORKS
BHJ	BHUJ
SHH	SHISHMAREF
SUL	SUI
BOY	BOBO DIOULASSO
YRC	chicoutimi st. honore airport
SJK	SAO JOSE DOS CAMPOS
QCE	COPPER MOUNTAIN
CHM	CHIMBOTE
SDD	LUBANGO
LDA	MALDA
ELD	EL DORADO
GXF	SEIYUN
ONX	COLON
CZX	CHANGZHOU
CER	CHERBOURG
BKQ	BLACKALL
MWD	MIANWALI
SSJ	SANDNESSJOEN
OMO	MOSTAR
CZE	CORO
WRE	WHANGAREI
YCZ	FAIRMOUNT SPRINGS
MXL	MEXICALI
AAG	ARAPOTI
CTS	SAPPORO CHITOSE
DLA	DOUALA
LBE	LATROBE
AVU	AVU AVU
OPU	BALIMO
LOV	MONCLOVA
ZFW	FAIRVIEW
WYA	WHYALLA
CBQ	CALABAR
MBX	MARIBOR
DAV	DAVID
UPG	UJUNG PANDANG
SHA	SHANGHAI
JFM	FREMANTLE
YXH	MEDICINE HAT
FRH	FRENCH LICK
ZBF	BATHURST
YFI	Firebag Airport
LML	LAE ISLAND
RNL	RENNELL
BQN	AGUADILLA
ORI	PORT LIONS
YMQ	MONTREAL (METROPOLITAN AREA)
LHW	LANZHOU
SYK	STYKKISHOLMUR
AGG	ANGORAM
KOD	KOTABANGUN
YOH	OXFORD HOUSE
IXA	AGARTALA
SMX	SANTA MARIA
UPN	URUAPAN
GOS	GOSFORD
SOF	SOFIA
MHR	MATHER AIRFORCE BASE
MIL	MILAN
YZR	SARNIA
BNV	BOANA
MJM	MBUJI-MAYI
AAN	AL AIN
EJA	BARRANCABERMEJA
TTE	TERNATE
TLS	TOULOUSE
SXE	SALE
SXS	SAHABAT 16
YAC	CAT LAKE
TML	TAMALE
GST	GUSTAVUS
MEG	MALANGE
IFO	IVANO-FRANKOVSK
JKT	JAKARTA
YCD	NANAIMO
BFF	SCOTTSBLUFF
BKA	MOSCOW
SGA	SHEGHNAN
IJU	IJUI
HZL	HAZLETON
LKB	LAKEBA
MYY	MIRI
IOA	IOANNINA
FMA	FORMOSA
BEY	BEIRUT
JOL	JOLO
CRM	CATARMAN
RAB	RABAUL
CMW	CAMAGUEY
CIV	CHOMLEY
NOS	NOSSI-BE
AJL	AIZAWL
RCN	AMERICAN RIVER
ASA	ASSAB
PRL	PORT OCEANIC
KOZ	OUZINKIE
KNN	KANKAN
KOC	KOUMAC
MKT	MANKATO
SCW	SYKTYVKAR
MLC	MCALESTER
NDY	SANDAY
HDD	HYDERABAD
VLG	VILLA GESELL
CXL	CALEXICO
KRB	KARUMBA
YNT	YANTAI
MCE	MERCED
TZX	TRABZON
HHH	HILTON HEAD ISLAND
IMA	IAMALELE
VDC	VITORIA DA CONQUISTA
YKY	KINDERSLEY
TMN	TAMANA ISLAND
LAI	LANNION
ANM	ANTALAHA
LII	MULIA
BJM	BUJUMBURA
MEV	MINDON
CGY	CAGAYAN DE ORO
PGV	GREENVILLE
EDL	ELDORET
CAW	CAMPOS
HHQ	HUA HIN
GZO	GIZO
ASD	ANDROS TOWN
KTF	TAKAKA
PCT	PRINCETON
YYH	TALOYOAK   (Spence Bay)
ADJ	AMMAN
HZG	HANZHONG
RDU	RALEIGH/DURHAM
YJF	FORT LIARD
AXK	ATAQ
KEM	KEMI
KLO	KALIBO
UPC	ZZZ
HXX	HAY
JOI	JOINVILLE
BEW	BEIRA
JFR	FREDERIKSHAAB
MQQ	MOUNDOU
CUE	CUENCA
PBD	PORBANDAR
YGH	FORT GOOD HOPE
TSX	TANJUNG SANTAN
BNU	BLUMENAU
YYU	KAPUSKASING
OKR	YORKE ISLAND
CCE	SAINT MARTIN GRAND CASE
BID	BLOCK ISLAND
WAT	WATERFORD
NMB	DAMAN
LMN	LIMBANG
HUL	HOULTON
OOK	TOKSOOK BAY
VTE	VIENTIANE
PCS	PICOS
ERF	ERFURT
GYA	GUAYARAMERIN
BWT	BURNIE
GUV	MOUGULU
THR	TEHRAN
HUI	HUE
AHU	AL HOCEIMA
SMS	SAINTE MARIE
YVQ	NORMAN WELLS
LIC	LIMON
YYC	CALGARY
RDV	RED DEVIL
PXO	PORTO SANTO
BTT	BETTLES
UNT	UNST
MQT	MARQUETTE
SLD	SLIAC
MUB	MAUN
ELY	ELY
HOD	HODEIDAH
PSC	PASCO
TYN	TAIYUAN
NAE	NATITINGOU
BUQ	BULAWAYO
MFR	MEDFORD
JEV	EVRY
GHA	GHARDAIA
KRR	KRASNODAR
KUQ	KURI
QJY	KOLOBRZEG
RKE	COPENHAGEN ROSKILDE APT
PWK	CHICAGO PALWAUKEE APT
MKD	CHAGNI
MAG	MADANG
KYZ	KYZYL
CZS	CRUZEIRO DO SUL
MTB	MONTE LIBANO
MRU	MAURITIUS
EMD	EMERALD
SBL	SANTA ANA
UDJ	UZHGOROD
HLD	HAILAR
SCG	SPRING CREEK
MSC	MESA FALCON
LDE	LOURDES/TARBES
CCJ	CALICUT
SHQ	SOUTHPORT
AJO	ALJOUF
PKB	PARKERSBURG/MARIETTA
STI	SANTIAGO
ORE	ORLEANS
TCE	TULCEA
EGS	EGILSSTADIR
OEC	OCUSSI
RVR	GREEN RIVER
AXA	ANGUILLA
KYD	ORCHID ISLAND
KWM	KOWANYAMA
HYA	HYANNIS
PAY	PAMOL
SLZ	SAO LUIZ
SAB	SABA
JAV	JAKOBSHAVN
GTO	GORONTALO
AAI	ARRAIAS
MDF	MEDFORD
LFR	LA FRIA
YUY	ROUYN
MTJ	MONTROSE
MPG	MAKINI
MTT	MINATITLAN
GRX	GRANADA
YGT	IGLOOLIK
HOB	HOBBS
HNM	HANA
NAS	NASSAU
ALF	ALTA
SGQ	SANGGATA
OMC	ORMOC
UBB	MABUIAG ISLAND
KWJ	KWANGJU
OTD	CONTADORA
STN	LONDON
SNR	SAINT NAZAIRE
EAT	WENATCHEE
BMD	BELO
HHA	HUANGHUA
UEO	KUME JIMA
SIS	SISHEN
VOG	VOLGOGRAD
DIK	DICKINSON
PIK	GLASGOW
RCQ	RECONQUISTA
TOV	TORTOLA
HYF	HAYFIELDS
ASJ	AMAMI O SHIMA
VIG	EL VIGIA
ZUM	CHURCHILL FALLS
THY	THOHOYANDOU
NLD	NUEVO LAREDO
YZV	SEPT-ILES
MBS	SAGINAW
AYP	AYACUCHO
CNP	EASTGREENLAND
MUJ	MUI
PKR	POKHARA
AMC	AM TIMAN
OSP	SLUPSK / REDZIKOWO
MVN	MOUNT VERNON
RWB	ROWAN BAY
AUZ	AURORA
STV	SURAT
YSF	STONY RAPIDS
LGL	LONG LELLANG
YRQ	TROIS_RIVIERES
EUG	EUGENE
SOT	SODANKYLA
KNQ	KONE
MGL	MONCHENGLADBACH
JAI	JAIPUR
MUZ	MUSOMA
ZEG	SENGGO
ONB	ONONGE
SKU	SKIROS
UYL	NYALA
BRR	BARRA
PVK	PREVEZA/LEFKAS
FLR	FLORENCE
BYD	BEIDAH
TOL	TOLEDO
PAV	PAULO AFONSO
JDX	HOUSTON
LEL	LAKE EVELLA
RCH	RIOHACHA
GYP	GYMPIE
STO	STOCKHOLM
HTI	HAMILTON ISLAND
AMS	AMSTERDAM
BTA	BERTOUA
SSB	SAINT CROIX SPB
SVX	EKATERINBURG
AXP	SPRING POINT
MGY	DAYTON MONTGOMERY COUNTY
OSR	OSTRAVA
VSG	VOROSHILOVGRAD
MXN	MORLAIX
SWP	SWAKOPMUND
MPV	MONTPELIER
EBG	EL BAGRE
GNZ	GHANZI
GPS	GALAPAGOS ISLAND
CLC	CLEAR LAKE CITY
BIL	BILLINGS
PUF	PAU
AUR	AURILLAC
PYM	PLYMOUTH
RCU	RIO CUARTO
YWN	WINISK
VAN	VAN
GOJ	NIZNIJ NOVGOROD
MSA	MUSKRAT DAM
SUN	SUN VALLEY
SAV	SAVANNAH
VHM	VILHELMINA
BGB	BOOUE
NTI	BINTUNI
AYN	ANYANG
GJA	GUANAJA
EXT	EXETER
YSJ	SAINT JOHN
TTJ	TOTTORI
MQX	MAKALE
NCN	NEW CHENEGA
AQJ	AQABA
BSV	BOSSET
MKG	MUSKEGON
YIP	DETROIT WILLOW RUN
KMY	MOSER BAY
MRW	MARIBO
MCJ	MAICAO
SCV	SUCEAVA
CCF	CARCASSONNE
LYG	LIANYUN'GANG
AYG	YAGUARA
KCH	KUCHING
ORG	PARAMARIBO ZORG EN HOOP
NSV	NOOSAVILLE
CYR	COLONIA
PLH	PLYMOUTH
LIG	LIMOGES
NTO	SANTO ANTAO
VGO	VIGO
HKN	HOSKINS
MEL	MELBOURNE
PMI	PALMA DE MALLORCA
MPL	MONTPELLIER
MBT	MASBATE
GUL	GOULBURN
MZZ	MARION
OUZ	ZOUERATE
YXX	ABBOTSFORD
BSL	BASLE
SKG	THESSALONIKI
LSQ	LOS ANGELES
MLH	MULHOUSE
CBD	CAR NICOBAR
KED	KAEDI
KDG	KARDJALI
IOP	IOMA
HTN	HOTAN
OYN	OUYEN
LSH	LASHIO
TXG	TAICHUNG
BKS	BENGKULU
KQL	KOL
MMG	MOUNT MAGNET
ZSA	SAN SALVADOR
ULP	QUILPIE
BXD	BADE
YBW	BEDWELL HARBOR
KPD	KING OF PRUSSIA
OMA	OMAHA
DTR	DECATUR ISLAND
EGX	EGEGIK
TCQ	TACNA
COL	COLL
PDA	PUERTO INIRIDA
BNI	BENIN CITY
SEQ	SUNGAI PAKNING
BWE	BRAUNSCHWEIG
PQC	PHUQUOC
SAQ	SAN ANDROS
YVA	MORONI
DOO	DOROBISORO
YCY	CLYDE RIVER
BDG	BLANDING
AZD	YAZD
SFH	SAN FELIPE
PZB	PIETERMARITZBURG
ONT	ONTARIO
OTZ	KOTZEBUE
KBH	KALAT
XBN	BINIGUNI
SLB	STORM LAKE
TOY	TOYAMA
WKK	ALEKNAGIK
CNQ	CORRIENTES
KKE	KERIKERI
LMI	LUMI
OLQ	OLSOBIP
AMU	AMANAB
YBM	BRONSON CREEK
TNK	TUNUNAK
WAE	WADI AD DAWASIR
OSA	OSAKA
MYW	MTWARA
CNC	COCONUT ISLAND
OUD	OUJDA
JSH	SITIA
TER	TERCEIRA
TBP	TUMBES
BDI	BIRD ISLAND
LCE	LA CEIBA
SWH	SWAN HILL
SVS	STEVENS VILLAGE
SCL	SANTIAGO
MNA	MELANGGUANE
ODW	OAK HARBOR
KLN	LARSEN BAY
ARA	NEW IBERIA, ACADIANA REGIONAL
YHC	HAKAI PASS
KAD	KADUNA
AMA	AMARILLO
KDH	KANDAHAR
WSM	WISEMAN
YCM	SAINT CATHARINES
SUY	SUDUREYRI
OPO	PORTO
SSM	SAULT SAINTE MARIE
TUF	TOURS
MUF	MUTING
KLL	LEVELOCK
PAW	PAMBWA
SWQ	SUMBAWA
FNR	FUNTER BAY
BUK	ALBUQ
TOK	TOROKINA
SFA	SFAX
MSO	MISSOULA
SDL	SUNDSVALL
UIN	QUINCY
LPI	LINKOPING
BBU	BUCHAREST BANEASA APT
KVD	GYANDZHA
YMH	MARY'S HARBOUR
RBI	RABI
AUY	ANEITYUM
EAX	BASLE/MULHOUSE
KDI	KENDARI
PLB	PLATTSBURGH
IVA	AMBANJA
PPN	POPAYAN
NCL	NEWCASTLE
HQM	HOQUIAM
VHZ	VAHITAHI
TJM	TYUMEN
PNP	POPONDETTA
SBW	SIBU
ROB	MONROVIA
MLA	MALTA
DOG	DONGOLA
CSG	COLUMBUS
WSZ	WESTPORT
IPA	IPOTA
UNE	QACHAS NEK
IXT	PASIGHAT
LEK	LABE
SJB	SAN JOAQUIN
JOG	YOGYAKARTA
KIN	KINGSTON
CVL	CAPE VOGEL
ACD	ACANDI
IAS	IASI
KUP	KUPIANO
KMV	KALEMYO
KGD	KALININGRAD
ATY	WATERTOWN
CAK	AKRON/CANTON
AKG	ANGUGANAK
PNE	PHILADELPHIA
TOG	TOGIAK
MOI	MITIARO ISLAND
ELW	ELLAMAR
ENC	NANCY
MAA	MADRAS
RCO	ROCHEFORT
VEY	VESTMANNAEYJAR
NNI	NAMUTONI
YMF	MONTAGNE HARBOR
FRA	FRANKFURT
NGB	NINGBO
VNE	VANNES
PQQ	PORT MACQUARIE
HNY	HENGYANG
WVB	WALVIS BAY
XPL	COMAYAGUA
CMN	CASABLANCA
YKA	KAMLOOPS
BLO	BLONDUOS
EAS	SAN SEBASTIAN
WOT	WONAN
IMF	IMPHAL
KER	KERMAN
HDN	STEAMBOAT SPRINGS HAYDEN YAMPA
SAT	SAN ANTONIO
PNQ	POONA
CYZ	CAUAYAN
ISB	ISLAMABAD
NGE	N'GAOUNDERE
ACY	ATLANTIC CITY INTERNATIONAL
YEA	EDMONTON METROPOLITAN AREA
JAL	JALAPA
YMS	YURIMAGUAS
CBE	CUMBERLAND
LIN	MILAN LINATE APT
PFO	PAPHOS
GLD	GOODLAND
SDR	SANTANDER
SDY	SIDNEY
STC	SAINT CLOUD
ADB	IZMIR ADNAN MENDERES APT
TRW	TARAWA
MTZ	MASSADA
LYC	LYCKSELE
SJX	SARTANEJA
KTR	KATHERINE
UYN	YULIN
CZB	CRUZ ALTA
WSR	WASIOR
DLM	DALAMAN
UVO	UVOL
SMM	SEMPORNA
KZS	KASTELORIZO
INW	WINSLOW
DAN	DANVILLE
DKR	DAKAR
KDU	SKARDU
XCH	CHRISTMAS ISLAND
LGG	LIEGE
TGL	TAGULA
FRB	FORBES
SHW	SHARURAH
JLP	JUAN LES PINS
SJF	SAINT JOHN
TTR	TANA TORAJA
HUV	HUDIKSVALL
ASE	ASPEN
TJV	THANJAVUR
YPT	PENDER HARBOR
YQB	QUEBEC
ACR	ARARACUARA
HAS	HAIL
BFM	MOBILE DOWNTOWN AEROSPACE
BDU	BARDUFOSS
MSH	MASIRAH
BMY	BELEP ISLAND
HGS	FREETOWN
CPN	CAPE RODNEY
WUG	WAU
UGC	URGENCH
SKE	SKIEN
MKZ	MALACCA
ALJ	ALEXANDER BAY
HFA	HAIFA
DDM	DODOIMA
AJU	ARACAJU
SUI	SUKHUMI
LPQ	LUANG PRABANG
AAK	ARANUKA
BLI	BELLINGHAM
PMN	PUMANI
ENU	ENUGU
RKT	RAS AL KHAIMAH
SLW	SALTILLO
MOV	MORANBAH
CGI	CAPE GIRARDEAU
YPA	PRINCE ALBERT
TAL	TANANA
MRV	MINERALNYE VODY
URO	ROUEN
VAR	VARNA
PIC	PINE CAY
KOO	KONGOLO
TAG	TAGBILARAN
PRG	PRAGUE
YVE	VERNON
VKT	VORKUTA
NWA	MOHELI
KOW	GANZHOU
SKO	SOKOTO
ECN	ERCAN
GNM	GUANAMBI
MXO	MONTICELLO
AIA	ALLIANCE
TAV	TAU
SUV	SUVA
SFJ	SONDRE STROMFJORD
HSM	HORSHAM
BER	BERLIN
YQW	NORTH BATTLEFORD
ZAG	ZAGREB
TEO	TERAPO
MNJ	MANANJARY
LCJ	LODZ / LUBLINEK
AIE	AIOME
MEA	MACAE
YYQ	CHURCHILL
BSK	BISKRA
LNE	LONORORE
HME	HASSI MESSAOUD
PCB	PONDOK CABE
NSM	NORSEMAN
ARE	ARECIBO
VSA	VILLAHERMOSA
UQE	QUEEN
ZST	STEWART
LPG	LA PLATA
LXG	LUANG NAMTHA
PIU	PIURA
TOU	TOUHO
YPE	PEACE RIVER
STG	SAINT GEORGE ISLAND
AZR	ADRAR
GGS	GOBERNADOR GREGORES
LAA	LAMAR
MDQ	MAR DEL PLATA
FCO	ROME FIUMICINO APT
RAI	PRAIA
IST	ISTANBUL
SWJ	SOUTH WEST BAY
GKA	GOROKA
WGB	BAHAWALNAGAR
MZR	MAZAR-I-SHARIF
LBJ	LABUAN BAJO
IRA	KIRAKIRA
UAH	UA HUKA
OSM	MOSUL
LGH	LEIGH CREEK
BUX	BUNIA
DOK	DONETSK
ATW	APPLETON
LNS	LANCASTER
ALS	ALAMOSA
MBD	MMABATHO
WMD	MANDABE
MPF	MAPODA
JPU	PARIS LA DEFENSE
EAR	KEARNEY
JXN	JACKSON
AAO	ANACO
BUH	BUCHAREST
FAE	FAROE ISLANDS
YST	SAINTE THERESE POINT
FJR	AL-FUJAIRAH
CEY	MURRAY
SKC	SUKI
RAM	RAMINGINING
MLQ	MALALAUA
ULE	SULE
PEL	PELANENG
SVM	SAINT PAUL'S MISSION
SZG	SALZBURG
HZP	Horizon Airport
MXK	MINDIK
CRL	CHARLEROI
ONS	ONSLOW
PNA	PAMPLONA
YBZ	TORONTO
MUW	MASCARA
PLQ	PALANGA
GET	GERALDTON
MAN	MANCHESTER
TTO	BRITTON
IMT	IRON MOUNTAIN
SRP	STORD
NPT	NEWPORT
HDY	HAT YAI
ECH	ECHUCA
SOJ	SORKJOSEN
MXG	MARLBOROUGH
RTA	ROTUMA ISLAND
TCB	TREASURE CAY
AGK	KAGUA
NDG	QIQIHAR
ALB	ALBANY
WKB	WARRACKNABEAL
WWP	WHALE PASS
RNI	CORN ISLAND
SQM	SAO MIGUEL DO ARAGUAIA
EZE	BUENOS AIRES
LUB	LUMID PAU
YZG	SALLUIT
CEO	WACO KUNGO
YMP	PORT MCNEIL
ANB	ANNISTON
IUL	ILU
RSK	RANSIKI
PVC	PROVINCETOWN
DRO	DURANGO
SYA	SHEMYA
KOR	KOKORO
NLG	NELSON LAGOON
PWM	PORTLAND
SXT	TAMAN NEGARA
JSA	JAISALMER
YWK	WABUSH
ICN	INCHON / KOREA
WTA	TAMBOHORANO
TSA	TAIPEI SUNG SHAN APT
VCF	VALCHETA
BCA	BARACOA
SVF	SAVE
BYB	DIBAA
CAN	GUANGZHOU
VDP	VALLE DE PASCUA
GAM	GAMBELL
MHY	MOREHEAD
ZQS	QUEEN CHARLOTTE
NNY	NANYANG
LBB	LUBBOCK
TYL	TALARA
RMD	RAMAGUNDAM
SBK	SAINT BRIEUC
URC	URUMQI
FLJ	FALLS BAY
TLH	TALLAHASSEE
WKA	WANAKA
POG	PORT GENTIL
YAP	YAP
CHY	CHOISEUL BAY
JHW	JAMESTOWN
LRU	LAS CRUCES
LGK	LANGKAWI
PRY	PRETORIA
EUN	LAAYOUNE
BDK	BONDOUKOU
ZIG	ZIGUINCHOR
BDO	BANDUNG
IMP	IMPERATRIZ
SWC	STAWELL
IQT	IQUITOS
URG	URUGUAIANA
GRQ	GRONINGEN
IYK	INYOKERN
YXJ	FORT SAINT JOHN
VAV	VAVA'U
ATM	ALTAMIRA
FIE	FAIR ISLE
YBY	BONNYVILLE
YKN	YANKTON
TUS	TUCSON
RSW	FORT MYERS SW FLORIDA
MSU	MASERU
MML	MARSHALL
GRP	GURUPI
SFQ	SANLIURFA
JUB	JUBA
PEN	PENANG
EWE	EWER
SST	SANTA TERESITA
PTF	MALOLOLAILAI
TAW	TACUAREMBO
HKK	HOKITIKA
TKJ	TOK
SIJ	SIGLUFJORDUR
IKI	IKI
ANS	ANDAHUAYLAS
RNN	RONNE
TXU	TABOU
MWZ	MWANZA
AHN	ATHENS
UGI	UGANIK
TEY	THINGEYRI
OZR	OZARK
COV	COVILHA
FRQ	FERAMIN
YMA	MAYO
FKS	FUKUSHIMA
YCN	COCHRANE
GEB	GEBE
RGT	RENGAT
CPV	CAMPINA GRANDE
ADD	ADDIS ABABA
PUZ	PUERTO CABEZAS
QPG	Paya Lebar Airport
FLT	FLAT
TLO	TOL
STL	ST. LOUIS
PHO	POINT HOPE
KPR	PORT WILLIAMS
NVT	NAVEGANTES
CCP	CONCEPCION
CNF	BELO HORIZONTE CONFINS
DTW	DETROIT METROPOLITAN APT
CPC	SAN MARTIN DE LOS ANDES
KWT	KWETHLUK
ZHA	ZHANJIANG
JON	JOHNSTON ISLAND
QKB	BRECKENRIDGE
THG	THANGOOL
IIA	INISHMAAN
FXE	FORT LAUDERDALE
OHI	OSHAKATI
NTN	NORMANTON
UIO	QUITO
URN	URGOON
SBI	KOUNDARA
DUB	DUBLIN
ZAL	VALDIVIA
MES	MEDAN
KDC	KANDI
AMQ	AMBON
ZYL	SYLHET
FAS	FASKRUDSFJORDUR
ENY	YAN'AN
CRW	CHARLESTON
PKZ	PAKSE
AEO	AIOUN EL ATROUSS
KAZ	KAU
VCE	VENICE
FKL	FRANKLIN
CKB	CLARKSBURG
BED	BEDFORD
LSC	LA SERENA
NOB	NOSARA BEACH
CIU	SAULT SAINTE MARIE CHIPPEWA CO
ROV	ROSTOV
AGM	ANGMAGSSALIK
UUD	ULAN-UDE
CKY	CONAKRY
LVO	LAVERTON
KSN	KUSTANAY
JGC	GRAND CANYON
CFR	CAEN
NLV	NIKOLAEV
BNC	BENI
GAJ	YAMAGATA
ULD	ULUNDI
LSE	LA CROSSE
SXB	STRASBOURG
NDC	NANDED
OMH	URMIEH
NCI	NECOCLI
YQL	LETHBRIDGE
MCL	MOUNT MCKINLEY
ESR	EL SALVADOR
BKX	BROOKINGS
EBA	ELBA ISLAND
YAX	ANGLING LAKE
MPN	MOUNT PLEASANT
RAZ	RAWALA KOT
KPG	KURUPUNG
RTP	RUTLAND PLAINS
GRS	GROSSETO
BFD	BRADFORD
GNI	GREEN ISLAND
TGG	KUALA TERENGGANU
KOA	KONA
KNH	KINMEN
AHO	ALGHERO
BEZ	BERU
IQM	QIEMO
LAN	LANSING
GRB	GREEN BAY
CLJ	CLUJ
UIP	QUIMPER
XKH	XIENG KHOUANG
LPC	LOMPOC
OTM	OTTUMWA
PGK	PANGKALPINANG
LMG	LAMASSA
YPS	PORT HAWKESBURY
ZSS	SASSANDRA
LOK	LODWAR
YPX	POVUNGNITUK
KEN	KENEMA
PPG	PAGO PAGO
WYE	YENGEMA
LSA	LOSUIA
VOI	VOINJAMA
KHM	KHAMTI
BWB	BARROW ISLAND
CIC	CHICO
CNJ	CLONCURRY
MTM	METLAKATLA
VTU	LAS TUNAS
GCN	GRAND CANYON
HUH	HUAHINE ISLAND
MLP	MALABANG
HLA	LANSERIA
AAU	ASAU
TWU	TAWAU
OUR	BATOURI
QRO	Queretaro Airport
WBU	BOULDER
BRM	BARQUISIMETO
YRA	RAE LAKES
OPB	OPEN BAY
WBQ	BEAVER
HOT	HOT SPRINGS
NPL	NEW PLYMOUTH
PTC	PORT ALICE
ABY	ALBANY
BTJ	BANDA ACEH
ISO	KINSTON
SPF	SPEARFISH
SHX	SHAGELUK
BXV	BREIDDALSVIK
BOV	BOANG
MSQ	MINSK
PEP	PEPPIMENARTI
GUG	GUARI
VDE	VALVERDE
ZGI	GODS RIVER
SYE	SA DAH
GWE	GWERU
PAN	PATTANI
LUD	LUDERITZ
APP	ASAPA
RBH	BROOKS LODGE
JBR	JONESBORO
VNA	SARAVANE
CUT	CUTRAL CO
KIR	KERRY COUNTY
LUR	CAPE LISBURNE
PMC	PUERTO MONTT
MJL	MOUILA
LVP	LAVAN
KTS	TELLER MISSION
MKR	MEEKATHARRA
LEI	ALMERIA
EZS	ELAZIG
WSN	SOUTH NAKNEK
CGK	JAKARTA SOEKARNO-HATTA
OBM	MOROBE
DBV	DUBROVNIK
JBS	PLEASANTON
PZL	PHINDA GAME RESERVE
KIY	KILWA
CHV	CHAVES
YUL	MONTREAL - PE TRUDEAU ARPT.
RKS	ROCK SPRINGS
YLL	LLOYDMINSTER
BHV	BAHAWALPUR
KDA	KOLDA
SWS	SWANSEA
QVG	VILGENIS
KRY	KARAMAY
JMU	JIAMUSI
KOY	OLGA BAY
SXF	BERLIN SCHONEFELD APT
HRB	HARBIN
SGF	SPRINGFIELD
SIT	SITKA
TII	TIRINKOT
WAF	WANA
WVL	WATERVILLE
LCY	LONDON
ADZ	SAN ANDRES ISLAND
PBM	PARAMARIBO
SHE	SHENYANG
LMA	LAKE MINCHUMINA
FLL	FORT LAUDERDALE
KBF	KARUBAGA
KRN	KIRUNA
HAM	HAMBURG
SJZ	SAO JORGE ISLAND
MJC	MAN
JEG	EGEDESMINDE
FUN	FUNAFUTI
ELL	ELLISRAS
THL	TACHILEK
FTA	FUTUNA ISLAND
BBF	BURLINGTON
GPT	GULFPORT
BKZ	BUKOBA
YSB	SUDBURY
OST	OSTEND
SLR	SULPHUR SPRINGS
PLS	PROVIDENCIALES
MNF	MANA
YFH	FORT HOPE
TTB	TORTOLI'/ARBATAX
TXN	TUNXI
YSY	SACHS HARBOUR
SXD	SOPHIA ANTIPOLIS
UTN	UPINGTON
MTO	MATTOON
MAV	MALOELAP ISLAND
CXA	CAICARA
PDB	PEDRO BAY
CAG	CAGLIARI
ETE	GENDA WUHA
MNS	MANSA
TYR	TYLER
MWF	MAEWO
LBL	LIBERAL
WIL	NAIROBI
BHR	BHARATPUR
YGP	GASPE
SWA	SHANTOU
PNS	PENSACOLA
CAL	CAMPBELTOWN
ZTL	TELLURIDE
GDV	GLENDIVE
BDJ	BANJARMASIN
UVA	UVALDE
MZL	MANIZALES
LGI	DEADMANS CAY
YPQ	PETERBOROUGH
SPS	WICHITA FALLS
YTC	STURDEE
IOS	ILHEUS
BOS	BOSTON LOGAN INTERNATIONAL APT
FOE	TOPEKA FORBES AFB
MHK	MANHATTAN
JGO	GODHAVN
GHT	GHAT
KTE	KERTEH
BNN	BRONNOYSUND
PZY	PIESTANY
PUB	PUEBLO
BEI	BEICA
EWB	NEW BEDFORD
DBD	DHANBAD
MAY	MANGROVE CAY
DJN	DELTA JUNCTION
OPA	KOPASKER
WOL	WOLLONGONG
MAO	MANAUS
MHG	MANNHEIM
KAR	KAMARANG
WTD	WEST END
YKQ	WASKAGANISH
SHS	SHASHI
ATR	ATAR
BNK	BALLINA
TGU	TEGUCIGALPA
KAL	KALTAG
KPY	PORT BAILEY
KKB	KITOI BAY
SXM	SAINT MAARTEN
OSS	OSH
REL	TRELEW
SVB	SAMBAVA
MAQ	MAE SOT
TNA	JINAN
TMG	TOMANGGONG
BHD	BELFAST
CAP	CAP HAITIEN
AEH	ABECHER
GFF	GRIFFITH
WTS	TSIROANOMANDIDY
HUQ	HOUN
NOM	NOMAD RIVER
DEC	DECATUR
KAG	KANGNUNG
AAA	ANAA
VEL	VERNAL
SRX	SERT
BGZ	BRAGA
NUP	NUNAPITCHUK
PPV	PORT PROTECTION
BBP	BEMBRIDGE
TSH	TSHIKAPA
DJG	DJANET
TJG	TANJUNG
AIS	ARORAE ISLAND
MRO	MASTERTON
KGW	KAGI
MKM	MUKAH
MHV	MOJAVE, CA
CWW	COROWA
LPA	GRAN CANARIA
TGV	TARGOVISHTE
YQV	YORKTON
TBS	TBILISI
GPB	GUARAPUAVA
DOA	DOANY
OYO	TRES ARROYOS
ACV	ARCATA/EUREKA
MIA	MIAMI
INO	INONGO
UTO	UTOPIA CREEK
CVN	CLOVIS
PIA	PEORIA
YAT	ATTAWAPISKAT
OBD	OBANO
DSE	DESSIE
LAK	AKLAVIK
OAK	OAKLAND
VEG	MAIKWAK
ELG	EL GOLEA
ZNE	NEWMAN
GND	GRENADA
ZDJ	BERNE
PTM	PALMARITO
HLZ	HAMILTON
NRT	TOKYO
YGK	KINGSTON
MRY	MONTEREY
CAY	CAYENNE
JNA	JANUARIA
PUJ	PUNTA CANA
CWL	CARDIFF
LHI	LEREH
JHL	Albian Aiport
WSY	AIRLIE BEACH
ARH	ARKHANGELSK
KSO	KASTORIA
WTO	WOTHO ISLAND
IJK	IZHEVSK
PHR	PACIFIC HARBOUR
KMM	KIMAM
MBJ	MONTEGO BAY
CRU	CARRIACOU
VPN	VOPNAFJORDUR
HIJ	HIROSHIMA
JAN	JACKSON
LAL	LAKELAND
IXS	SILCHAR
ROR	KOROR
BUE	BUENOS AIRES
AJN	ANJOUAN
HUU	HUANUCO
MEC	MANTA
SOE	SOUANKE
YMX	MONTREAL - MIRABEL AIRPORT
LBW	LONG BAWAN
DRG	DEERING
DMU	DIMAPUR
KCQ	CHIGNIK LAKE
NGS	NAGASAKI
GUI	GUIRIA
SRE	SUCRE
DOH	DOHA
TFM	TELEFOMIN
SHR	SHERIDAN
VTZ	VISHAKHAPATNAM
ZAH	ZAHEDAN
SMF	SACRAMENTO
HWA	HAWABANGO
JRO	KILIMANJARO
TAI	TAIZ
JNS	NARSSAQ
ASX	ASHLAND
MYR	MYRTLE BEACH
SAF	SANTA FE
OUL	OULU
RIY	RIYAN/MUKALLA
KMR	KARIMUI
NHS	NUSHKI
KSK	KARLSKOGA
JOE	JOENSUU
UOX	UNIVERSITY
GTN	MOUNT COOK GLENTANNER
GFB	TOGIAK FISH
KCA	KUQA
OLJ	OLPOI
YVT	BUFFALO NARROWS
OGG	KAHULUI
BBH	BARTH
FAA	FARANAH
LUJ	LUSIKISIKI
LON	LONDON
DTD	DATADAWAI
OME	NOME
SBV	SABAH
CLE	CLEVELAND
VRA	VARADERO
PRN	PRISTINA
MXC	MONTICELLO
MJY	MANGUNJAYA
BKB	BIKANER
WPB	PORT BERGE
WMB	WARRNAMBOOL
KUF	SAMARA
ORK	CORK
LVI	LIVINGSTONE
UGO	UIGE
KID	KRISTIANSTAD
IDR	INDORE
INZ	IN SALAH
TXL	BERLIN TEGEL APT
KAW	KAWTHAUNG
KVG	KAVIENG
SUE	STURGEON BAY
MYM	MONKEY MOUNTAIN
TUJ	TUM
GRZ	GRAZ
OVA	BEKILY
BGM	BINGHAMTON
VXC	LICHINGA
WYS	WEST YELLOWSTONE
YOJ	HIGH LEVEL
ZOS	OSORNO
AGX	AGATTI ISLAND
PMP	PIMAGA
BDA	BERMUDA
WUH	WUHAN
ROU	RUSE
GUC	GUNNISON
HUN	HUALIEN
ZBV	BEAVER CREEK
CUL	CULIACAN
NBO	NAIROBI
KZF	KAINTIBA
TVA	MORAFENOBE
AKI	AKIAK
UKR	MUKEIRAS
OND	ONDANGWA
KPI	KAPIT
CIK	CHALKYITSIK
JHG	JINGHONG
BJW	BAJAWA
NMG	SAN MIGUEL
YWP	WEBEQUIE
MGS	MANGAIA ISLAND
RTS	ROTTNEST ISLAND
VCB	VIEW COVE
SKK	SHAKTOOLIK
KRW	KRASNOVODSK
HTU	HOPETOUN
SZA	SOYO
EYW	KEY WEST
REY	REYES
GIS	GISBORNE
PDF	PRADO
ZWL	WOLLASTON LAKE
CIX	CHICLAYO
VRY	VAEROY
SSW	STUART ISLAND
MEH	MEHAMN
GOB	GOBA
ZJG	JENPEG
NUE	NUREMBERG
SCN	SAARBRUCKEN
SIB	SIBITI
JMK	MYKONOS
BAL	BATMAN
DAU	DARU
HMJ	KHMELNITSKIY
PUY	PULA
IRB	IRAAN
MRQ	MARINDUQUE
SPU	SPLIT
YBL	CAMPBELL RIVER
SZS	STEWART ISLAND
SSZ	SANTOS
KND	KINDU
BVM	BELMONTE
GTB	GENTING
WDN	WALDRON ISLAND
LOH	LOJA
MAH	MENORCA
TRG	TAURANGA
BRD	BRAINERD
OAJ	JACKSONVILLE
GAZ	GUASOPA
WED	WEDAU
LIS	LISBON
AER	SOCHI
CIH	CHANGZHI
HID	HORN ISLAND
CMB	COLOMBO
BUA	BUKA
MVO	MONGO
BOO	BODO
ULB	ULEI
MAU	MAUPITI ISLAND
MMX	MALMO STURUP APT
AVP	WILKES-BARRE
DPS	DENPASAR-BALI
MDE	MEDELLIN
ZAK	CHIUSA
NQN	NEUQUEN
BBX	BLUE BELL
TLP	TUMOLBIL
BCE	BRYCE
GBC	GASUKE
IBA	IBADAN
BBA	BALMACEDA
IRJ	LA RIOJA
VIL	DAKHLA
TWN	TEWANTIN
POQ	POLK INLET
LAO	LAOAG
MAP	MAMAI
KUS	KULUSUK ISLAND
SJE	SAN JOSE DEL GUAVIARE
BQO	BOUNA
XRY	JEREZ DE LA FRONTERA
LPE	LA PRIMAVERA
STP	SAINT PAUL
WSU	WASU
XMI	MASASI
BPY	BESALAMPY
SYD	SYDNEY
UAK	NARSSARSSUAQ
MMP	MOMPOS
ITN	ITABUNA
FTU	FORT DAUPHIN
RTB	ROATAN
IQN	QINGYANG
PKW	SELEBI-PHIKWE
HOM	HOMER
HAX	MUSKOGEE HATBOX
MPA	MPACHA
RNO	RENO
BDQ	VADODARA
MMU	MORRISTOWN
YSR	NANISIVIK
BMW	BORDJ BADJI MOKHTAR
TKI	TOKEEN
YRF	CARTWRIGHT
XNN	XINING
LTN	LONDON LUTON
SLU	SAINT LUCIA
CNS	CAIRNS
VRK	VARKAUS
BVY	BEVERLY
IDN	INDAGEN
BSS	BALSAS
JOH	PORT SAINT JOHNS
NVY	NEYVELI
MFA	MAFIA
MMJ	MATSUMOTO
LGA	NEW YORK LA GUARDIA APT
COC	CONCORDIA
HET	HOHHOT
TOH	TORRES
DCM	CASTRES
JSZ	SAINT TROPEZ
RIL	RIFLE
VVI	SANTA CRUZ VIRU VIRU
BDS	BRINDISI
CMU	KUNDIAWA
KUD	KUDAT
ATL	ATLANTA
MYC	MARACAY
IXB	BAGDOGRA
ILM	WILMINGTON
KLK	KALOKOL
ZSE	SAINT PIERRE DE LA REUNION
MVX	MINVOUL
AGE	WANGEROOGE
MGP	MANGA
ARM	ARMIDALE
RZA	SANTA CRUZ
AUU	AURUKUN MISSION
PPQ	PARAPARAUMU
PDT	PENDLETON
LCG	LA CORUNA
GCI	GUERNSEY
RHD	RIO HONDO
JIM	JIMMA
DAJ	DAUAN ISLAND
TMP	TAMPERE
XSI	SOUTH INDIAN LAKE
IIS	NISSAN ISLAND
EBU	SAINT ETIENNE
WTP	WOITAPE
PMO	PALERMO
IAD	WASHINGTON DULLES INT APT
TIC	TINAK ISLAND
JWH	HOUSTON WESTCHASE
GIZ	GIZAN
CPQ	CAMPINAS
BJR	BAHAR DAR
HBN	PHU-BON
GLR	GAYLORD
MKK	HOOLEHUA
WNN	WUNNUMMIN LAKE
RBY	RUBY
WTC	N.Y. WORLD TRADE CENTER H/P
GOM	GOMA
CAI	CAIRO
EUX	SAINT EUSTATIUS
BBQ	BARBUDA
CDA	COOINDA
UDR	UDAIPUR
TEI	TEZU
YYJ	VICTORIA
CBZ	CABIN CREEK
ZRC	SAN PEDRO DE ALCANTARA
RPM	NGUKURR
BHZ	BELO HORIZONTE
PRA	PARANA
PDL	PONTA DELGADA
SCO	SHEVCHENKO
TUZ	TUCUMA
FUG	FUYANG
STZ	SANTA TEREZINHA
PND	PUNTA GORDA
CWI	CLINTON
OLF	WOLF POINT
LCD	LOUIS TRICHARDT
MMA	MALMO
VAI	VANIMO
NCU	NUKUS
YYE	FORT NELSON
TFI	TUFI
MSS	MASSENA
PMQ	PERITO MORENO
ZIH	IXTAPA/ZIHUATANEJO
SEY	SELIBABY
ITO	HILO
JYV	JYVASKYLA
AAX	ARAXIA MINAS GERAIS
CHB	CHILAS
HUC	HUMACAO
GJT	GRAND JUNCTION
RGN	YANGON
YZP	SANDSPIT
SPD	SAIDPUR
CXI	CHRISTMAS ISLAND
OTU	OTU
KSC	KOSICE
COO	COTONOU
SNY	SIDNEY
HRE	HARARE
BII	BIKINI ATOLL
TBE	TIMBUNKE
BYM	BAYAMO
BEL	BELEM
APF	NAPLES
LTL	LASTOURVILLE
PAC	PANAMA CITY
TXK	TEXARKANA
SYX	SANYA
MYN	MAREB
VHY	VICHY
DYU	DUSHANBE
VRU	VRYBURG
YDL	DEASE LAKE
EMI	EMIRAU
OTR	COTO 47
PFN	PANAMA CITY BAY
PPC	PROSPECT CREEK
MKY	MACKAY
YWS	WHISTLER
BLA	BARCELONA
GRY	GRIMSEY
LNY	LANAI CITY
TCT	TAKOTNA
MDZ	MENDOZA
YRJ	ROBERVAL
TBF	TABITEUEA NORTH
AEP	BUENOS AIRES AEROPARQUE JORGE
KUT	KUTAISI
FSM	FORT SMITH
SHJ	SHARJAH
OKU	MOKUTI LODGE
UAC	SAN LUIS RIO COLORADO
KIW	KITWE
RUA	ARUA
SWF	NEWBURGH
TIN	TINDOUF
RAW	ARAWA
CDH	CAMDEN
TRK	TARAKAN
SLV	SIMLA
BUF	BUFFALO
NYE	NYERI
TNJ	TANJUNG PINANG
BSO	BASCO
LIO	LIMON
MSX	MOSSENDJO
OMS	OMSK
MDT	HARRISBURG
GTI	RUEGEN
HMS	HOME SHORE
BIM	BIMINI
YCR	CROSS LAKE
WBO	BEROROHA
AGS	AUGUSTA
HFE	HEFEI
LTD	GHADAMES
YGX	GILLAM
YPP	PINE POINT
HTO	EAST HAMPTON
CEI	CHIANG RAI
TDJ	TADJOURA
NNL	NONDALTON
BJZ	BADAJOZ
VAG	VARGINHA
CIL	COUNCIL
FRS	FLORES
BEN	BENGHAZI
CLK	CLINTON
PDP	PUNTA DEL ESTE
RIW	RIVERTON
PEU	PUERTO LEMPIRA
HIB	HIBBING/CHISHOLM
WJF	LANCASTER
TNX	STUNG TRENG
DNF	DERNA
TKU	TURKU
KMI	MIYAZAKI
MSJ	MISAWA
SBN	SOUTH BEND
ZGU	GAUA
YDN	DAUPHIN
YRS	RED SUCKER LAKE
HZK	HUSAVIK
VOL	ZZZ
CSK	CAP SKIRRING
WWT	NEWTOK
AOS	AMOOK
AAE	ANNABA
BAM	BATTLE MOUNTAIN
PPU	PAPUN
AAF	APALACHICOLA
BFI	SEATTLE BOEING FIELD
MOE	MOMEIK
KSI	KISSIDOUGOU
FOR	FORTALEZA
KRZ	KIRI
NUK	NUKUTAVAKE
ERM	ERECHIM
KNU	KANPUR
DYG	DAYONG
TVL	LAKE TAHOE
BUP	BHATINDA
DHN	DOTHAN
AKV	AKULIVIK
EAM	NEJRAN
CCM	CRICIUMA
AJA	AJACCIO
CFS	COFFS HARBOUR
MFN	MILFORD SOUND
KGY	KINGAROY
YNM	MATAGAMI
AES	AALESUND
WET	WAGETHE
OFU	OFU
NSY	SIGONELLA
TKM	TIKAL
GOT	GOTHENBURG LANDVETTER APT
IXE	MANGALORE
TSU	TABITEUEA SOUTH
MOC	MONTES CLAROS
LWY	LAWAS
BOM	MUMBAI
TIO	TILIN
TRU	TRUJILLO
PBL	PUERTO CABELLO
YIF	PAKUASHIPI
CZL	CONSTANTINE
YTG	SULLIVAN BAY
ZRI	SERUI
UAP	UA POU
MBB	MARBLE BAR
RBP	RABARABA
BLE	BORLANGE
TIF	TAIF
GMR	GAMBIER ISLAND
TBM	TUMBANG SAMBA
HTA	CHITA
MCU	MONTLUCON
JJN	JINJIANG
ASF	ASTRAKHAN
REN	ORENBURG
PKU	PEKANBARU
LRG	LORALAI
ROW	ROSWELL
MZG	MAKUNG
HTS	HUNTINGTON
MQF	MAGNITOGORSK
HUE	HUMERA
GUP	GALLUP
KQA	AKUTAN
AAQ	ANAPA
LRH	LA ROCHELLE
KMX	KHAMIS MUSHAIT
ANV	ANVIK
PWQ	PAVLODAR
WHD	HYDER
MCZ	MACEIO
BRW	BARROW
RAR	RAROTONGA
BGR	BANGOR
ZHP	HIGH PRAIRIE
SDP	SAND POINT
CDJ	CONCEICAO DO ARAGUAIA
PHL	PHILADELPHIA
CPO	COPIAPO
LPU	LONG APUNG
AMY	AMBATOMAINTY
CEN	CIUDAD OBREGON
CXH	VANCOUVER COAL HARBOUR SPB
JPA	JOAO PESSOA
VDS	VADSO
SIM	SIMBAI
JSR	JESSORE
HYS	HAYS
SNV	SANTA ELENA
DAP	DARCHULA
DED	DEHRA DUN
YHA	PORT HOPE SIMPSON
MMO	MAIO
FNI	NIMES
OTC	BOL
BSX	BASSEIN
DLG	DILLINGHAM
OFK	NORFOLK
ORT	NORTHWAY
PEC	PELICAN
LUK	CINCINNATI
SVJ	SVOLVAER
ANC	ANCHORAGE
CLQ	COLIMA
EUA	EUA
DYA	DYSART
ABL	AMBLER
BZE	BELIZE CITY
CHQ	CHANIA
BHI	BAHIA BLANCA
MGH	MARGATE
TMX	TIMIMOUN
LAB	LABLAB
LEQ	LANDS END
YIB	ATIKOKAN
SRI	SAMARINDA
CMG	CORUMBA
XIY	XI'AN
HVR	HAVRE
XSP	SINGAPORE
PJG	PANJGUR
KGJ	KARONGA
TIU	TIMARU
CUR	CURACAO
KLU	KLAGENFURT
MSE	MANSTON
NTJ	MANTI
PCR	PUERTO CARRENO
TRI	TRI-CITY AIRPORT
CEU	CLEMSON
ITH	ITHACA
PPF	PARSONS
ETH	ELAT
PSS	POSADAS
TTT	TAITUNG
KDS	KAMARAN DOWNS
VSE	VISEU
REU	REUS
TIE	TIPPI
KIO	KILI ISLAND
MFI	MARSHFIELD
FSD	SIOUX FALLS
YJT	STEPHENVILLE
MXS	MAOTA
OOT	ONOTOA
MKU	MAKOKOU
JGE	GEOJE
NLL	NULLAGINE
RIO	RIO DE JANEIRO
DES	DESROCHES
XFW	HAMBURG
BWD	BROWNWOOD
MXH	MORO
TRA	TARAMAJIMA
CXT	CHARTERS TOWERS
PUM	POMALA
ISW	WISCONSIN RAPIDS
KBP	KIEV
PGH	PANTNAGAR
NIM	NIAMEY
SDU	RIO DE JANEIRO
PDS	PIEDRAS NEGRAS
BIN	BAMIYAN
KSU	KRISTIANSUND / KVERNBERGET
BPH	BISLIG
TEK	TATITLEK
TPG	TAIPING
RYN	ROYAN
WAK	ANKAZOABO
VVO	VLADIVOSTOK
ILN	WILMINGTON
LIK	LIKIEP ISLAND
SSG	MALABO
ELP	EL PASO
MCM	MONTE CARLO
CCR	CONCORD
KGH	YONGAI
CWA	WAUSAU
OSD	OSTERSUND
KZB	ZACHAR BAY
SDN	SANDANE
CBR	CANBERRA
RBA	RABAT
JIB	DJIBOUTI
BHU	BHAVNAGAR
MKW	MANOKWARI
TKV	TATAKOTO
LXA	LHASA
CST	CASTAWAY
BNX	BANJA LUKA
RIG	RIO GRANDE
AVB	AVIANO
TVU	TAVEUNI
CGN	COLOGNE
AKN	KING SALMON
CYP	CALBAYOG
KBT	KABEN
BMH	BOMAI
AJR	ARVIDSJAUR
YWH	VICTORIA (INNER HARBOUR)
HAR	HARRISBURG
SOW	SHOW LOW
MFG	MUZAFFARABAD
EGN	GENEINA
SMZ	STOELMANSEILAND
GRJ	GEORGE
HOH	HOHENEMS
ELS	EAST LONDON
LPS	LOPEZ ISLAND
WAD	ANDRIAMENA
POU	POUGHKEEPSIE
HBG	HATTIESBURG
SFT	SKELLEFTEA
PLE	PAIELA
ELH	NORTH ELEUTHERA
LWN	LENINAKAN
XSE	SEBBA
PVA	PROVIDENCIA
BOK	BROOKINGS
AUO	AUBURN
ZAC	YORK LANDING
MHA	MAHDIA
YIN	YINING
KTT	KITTILA
SWU	SU WON CITY
PVG	PU DONG
WSO	WASHABO
EGM	SEGE
QDM	DAMMAM
SFF	SPOKANE FELTS FIELD
DBM	DEBRE MARCOS
LRA	LARISSA
ALZ	ALITAK
KRK	KRAKOW / BALICE
CFU	CORFU
EFB	EIGHT FATHOM BIGHT
BKJ	BOKE
NQY	NEWQUAY
ASR	KAYSERI
CPT	CAPE TOWN
NSN	NELSON
YGJ	YONAGO
PWL	PURWOKERTO
XLB	LAC BROCHET
OHT	KOHAT
SBS	STEAMBOAT SPRINGS
YKG	KANGIRSUK
MGK	MONG TON
FOD	FORT DODGE
GDO	GUASDUALITO
LAU	LAMU
CNB	COONAMBLE
BAU	BAURU
EHM	CAPE NEWENHAM
CQT	CAQUETANIA
HAJ	HANOVER
ATQ	AMRITSAR
TIP	TRIPOLI
YLD	CHAPLEAU
INI	NIS
OSK	OSKARSHAMN
MLS	MILES CITY
EAY	BASLE/MULHOUSE
WMN	MAROANTSETRA
OBU	KOBUK
DIS	LOUBOMO
AUL	AUR ISLAND
ESC	ESCANABA
CUD	CALOUNDRA
MIK	MIKKELI
MZM	METZ
GAE	GABES
WIN	WINTON
YAS	YASAWA ISLAND
SEB	SEBHA
BNS	BARINAS
JNB	JOHANNESBURG
BUW	BAUBAU
JAC	JACKSON
EPR	ESPERANCE
DNB	DUNBAR
XQU	QUALICUM
SNG	SAN IGNACIO DE VELASCO
DSD	DESIRADE
TSF	VENICE
DBY	DALBY
AQI	QAISUMAH
VEV	BARAKOMA
AOJ	AOMORI
BUS	BATUMI
SVZ	SAN ANTONIO
IFJ	ISAFJORDUR
YVD	YEVA
PHT	PARIS
YOY	VALCARTIER
CKD	CROOKED CREEK
BXC	BOXBOROUGH
FLC	FALLS CREEK
NBC	NABEREVNYE CHELNYE
OKG	OKOYO
XRR	ROSS RIVER
SCC	PRUDHOE BAY/DEADHORSE
ADW	CAMP SPRINGS
BIG	BIG DELTA
YCL	CHARLO
FRP	FRESH WATER BAY
AEX	ALEXANDRIA ENGLAND AFB
GCC	GILLETTE
QKL	COLOGNE
MYU	MEKORYUK
TPL	TEMPLE
VDB	FAGERNES
INN	INNSBRUCK
RSA	SANTA ROSA
LGO	LANGEOOG
CIA	ROME CIAMPINO APT
BSU	BASANKUSU
IRP	ISIRO
TVC	TRAVERSE CITY
IKA	Imam Khomeini
GCA	GUACAMAYA
COG	CONDOTO
LMC	LA MACARENA
TLJ	TATALINA
IGA	INAGUA
KNK	KAKHONAK
OLM	OLYMPIA
TRN	TURIN
RZE	RZESZOW / JASIONKA
ORH	WORCESTER
BTE	BONTHE
DGC	DEGAHBUR
ZSJ	SANDY LAKE
BFL	BAKERSFIELD
TUB	TUBUAI
MMK	MURMANSK
TRO	TAREE
WBN	WOBURN
CBB	COCHABAMBA
YTH	THOMPSON
PDX	PORTLAND
MAL	MANGOLE
BLH	BLYTHE
GAR	GARAINA
IWA	IVANOVO
CNX	CHIANG MAI
LNZ	LINZ
HFS	HAGFORS
YYZ	TORONTO, LB PEARSON ARPT.
DME	MOSCOW DOMODEDOVO APT
TOP	TOPEKA
GUU	GRUNDARFJORDUR
JGN	JIAYUGUAN
KPC	PORT CLARENCE
YAZ	TOFINO
LDB	LONDRINA
BQK	BRUNSWICK GLYNCO JETPORT
TPC	TARAPOA
LGP	LEGASPI
LPT	LAMPANG
BVG	BERLEVAG
CVG	CINCINNATI
PSA	PISA
KYP	KYAUKPYU
UGB	PILOT POINT UGASHIK BAY
UKK	UST-KAMENOGORSK
LNF	MUNBIL
IGM	KINGMAN
TLA	TELLER
AMP	AMPANIHY
YCC	CORNWALL
VAW	VARDOE
ZFN	FORT NORMAN
WHS	WHALSAY
YHP	POPLAR HILL
MPU	MAPUA
YQD	THE PAS
CPH	COPENHAGEN AIRPORT
TAK	TAKAMATSU
ING	LAGO ARGENTINO
RMP	RAMPART
DNZ	DENIZLI
YET	EDSON
LHG	LIGHTNING RIDGE
LYH	LYNCHBURG
APQ	ARAPIRACA
OPF	MIAMI
ELV	ELFIN COVE
CHG	CHAOYANG
YKU	CHISASIBI
SZK	SKUKUZA
DJO	DALOA
IZO	IZUMO
VIV	VIVIGANI
GES	GENERAL SANTOS
PQS	PILOT STATION
CUM	CUMANA
AYT	ANTALYA
POC	LA VERNE
AGD	ANGGI
SSY	M'BANZA CONGO
BHM	BIRMINGHAM
PRH	PHRAE
LTM	LETHEM
IXM	MADURAI
MVF	MOSSORO
CTG	CARTAGENA
MCY	SUNSHINE COAST
IKP	INKERMAN
KSH	BAKHTARAN
TFT	TAFTAN
RUS	MARAU ISLAND
MEO	MANTEO
ASW	ASWAN
LKA	LARANTUKA
ABR	ABERDEEN
HBA	HOBART
YKS	YAKUTSK
AGB	AUGSBURG
ITK	ITOKAMA
JHQ	SHUTE HARBOUR
SFD	SAN FERNANDO DE APURE
IMD	IMONDA
MBW	MOORABBIN
SKS	VOJENS LUFTHAVN
EQS	ESQUEL
ZSZ	SPIEZ STATION
MYS	MOYALE
ANR	ANTWERP
SQV	SEQUIM
LZR	LIZARD ISLAND
FAT	FRESNO
BGW	BAGHDAD
HRM	HASSI R MEL
SXO	SAO FELIX DO ARAGUAIA
REG	REGGIO CALABRIA
BLG	BELAGA
MQS	MUSTIQUE
TNP	TWENTYNINE PALMS
LHB	LOST HARBOR
PAU	PAUK
ALR	ALEXANDRA
KNX	KUNUNURRA
CGC	CAPE GLOUCESTER
EMY	EL MINYA
UOL	BUOL
OBY	SCORESBYSUND
CTM	CHETUMAL
MNZ	MANASSAS
OTS	ANACORTES
KVL	KIVALINA
OKC	OKLAHOMA CITY
YBK	BAKER LAKE
IKS	TIKSI
CPF	CEPU
NSX	NORTH SOUND
AKU	AKSU
INK	WINK
ERZ	ERZURUM
LER	LEINSTER
CUZ	CUSCO
SSH	SHARM EL SHEIK
OLB	OLBIA
UND	KUNDUZ
BXU	BUTUAN
DHA	DHAHRAN
VRL	VILA REAL
EMO	EMO
MEE	MARE
NZE	NZEREKORE
XPK	PUKATAWAGAN
BZV	BRAZZAVILLE
ENH	ENSHI
AZO	KALAMAZOO
GZM	GOZO
IPT	WILLIAMSPORT
ZKG	KEGASKA
NTT	NIUATOPUTAPU
CES	CESSNOCK
FBU	OSLO FORNEBU APT
ZRH	ZURICH
OYE	OYEM
CCT	COLONIA CATRIEL
DKI	DUNK ISLAND
AXD	ALEXANDROUPOLIS
KSQ	KARSHI
MTR	MONTERIA
AXS	ALTUS
OCI	OCEANIC
LSM	LONG SEMADO
ZBR	CHAH-BAHAR
YPM	PIKANGIKUM
RFD	ROCKFORD
UJE	UJAE ISLAND
YRB	RESOLUTE
PHS	PHITSANULOK
IPL	IMPERIAL
ZNZ	ZANZIBAR
PVH	PORTO VELHO
GMB	GAMBELA
RBJ	REBUN
YKE	KNEE LAKE
ALY	ALEXANDRIA
XDJ	DJIBO
COJ	COONABARABRAN
CCB	UPLAND
DIR	DIRE DAWA
DGE	MUDGEE
BKW	BECKLEY
BAG	BAGUIO
BNA	NASHVILLE
PLM	PALEMBANG
RTW	SARATOV
CGO	ZHENGZHOU
KPO	P'OHANG
UVF	SAINT LUCIA HEWANORRA
NCS	NEWCASTLE
KOI	KIRKWALL
JFK	NEW YORK JFK APT
ZVA	MIANDRIVAZO
GWT	WESTERLAND
NAM	NAMLEA
ENF	ENONTEKIO
YXD	EDMONTON MUNICIPAL ARPT
ILR	ILORIN
KME	KAMEMBE
KUG	KUBIN ISLAND
FRJ	FREJUS
STB	SANTA BARBARA (ZULIA)
SBU	SPRINGBOK
LAX	LOS ANGELES
KHH	KAOHSIUNG
TIH	TIKEHAU ATOLL
SVY	SAVO
SMI	SAMOS
TJQ	TANJUNG PANDAN
SLI	SOLWEZI
PSE	PONCE
OKI	OKI ISLAND
CND	CONSTANTA
GGT	GEORGE TOWN
SHU	SMITH POINT
SIN	SINGAPORE
FLW	FLORES ISLAND
BNF	BARANOF
WNC	NICHIN COVE
KDD	KHUZDAR
RNS	RENNES
LME	LE MANS
BMU	BIMA
LSX	LHOK SUKON
VVC	VILLAVICENCIO
NCH	NACHINGWEA
GAL	GALENA
TSE	TSELINOGRAD
UBP	UBON RATCHATHANI
PBH	PARO
CLP	CLARKS POINT
INC	YINCHUAN
KIH	KISH ISLAND
OGX	OUARGLA
WEI	WEIPA
SGR	SUGAR LAND
YQR	REGINA
KOS	KOMPONGSOM
KFG	KALKURANG
OGS	OGDENSBURG
MRG	MAREEBA
LSP	LAS PIEDRAS
SJT	SAN ANGELO
ORA	ORAN
AAB	ARRABURY
VLS	VALESDIR
MVD	MONTEVIDEO
KHN	NANCHANG
STS	SANTA ROSA
OVB	NOVOSIBIRSK
ASB	ASHKHABAD
CEP	CONCEPCION
ELJ	EL RECREO
LIP	LINS
LAW	LAWTON
OKL	OKSIBIL
MZV	MULU
GLI	GLEN INNES
BVC	BOA VISTA
ICI	CICIA
KBX	KAMBUAYA
WLK	SELAWIK
PTY	PANAMA CITY/BALBOA
UTK	UTIRIK ISLAND
MDI	MAKURDI
XBE	BEARSKIN LAKE
GLV	GOLOVIN
CMI	CHAMPAIGN
KVX	KIROV
YBJ	BAIE JOHAN BEETZ
MVP	MITU
UVE	OUVEA
YEB	BAR RIVER
ESA	ESA'ALA
FOG	FOGGIA
RBQ	RURRENABAQUE
BHY	BEIHAI
BOI	BOISE
YFJ	SNARE LAKE, NT
RVY	RIVERA
PIP	PILOT POINT
CGQ	CHANGCHUN
CQF	CALAIS/DUNKERQUE
DET	DETROIT CITY
PLF	PALA
DZA	DZAOUDZI
EFL	KEFALLINIA
COK	COCHIN
SPY	SAN PEDRO
PTX	PITALITO
YHS	SECHELT
PAP	PORT AU PRINCE
YIW	YIWU
YTS	TIMMINS
LKN	LEKNES
OGE	OGERANANG
XFN	XIANGFAN
MXP	MILAN MALPENSA APT
ARP	ARAGIP
ENN	NENANA
AEA	ABEMAMA ATOLL
HOV	ORSTA-VOLDA
PNB	PORTO NACIONAL
LUM	LUXI
CMX	HANCOCK
PBR	PUERTO BARRIOS
GVI	GREEN RIVER
GYM	GUAYMAS
LIQ	LISALA
PUD	PUERTO DESEADO
CSE	CRESTED BUTTE
DOF	DORA BAY
FLG	FLAGSTAFF
ELC	ELCHO ISLAND
JKG	JONKOPING
BAQ	BARRANQUILLA
RTE	MARGUERITE BAY
CTW	COTTONWOOD
RSU	YOSU
LYK	LUNYUK
LXS	LEMNOS
LYP	FAISALABAD
SDF	LOUISVILLE
TVF	THIEF RIVER FALLS
EOZ	ELORZA
BHK	BUKHARA
JLR	JABALPUR
ROY	RIO MAYO
VQS	VIEQUES
BPN	BALIKPAPAN
DAE	DAPARIZO
LDZ	LONDOLOZI
NAR	NARE
MSP	MINNEAPOLIS INTERNATIONAL APT
GAX	GAMBA
JGA	JAMNAGAR
WWR	WOODWARD
OZC	OZAMIS
SDI	SAIDOR
MOU	MOUNTAIN VILLAGE
SNC	SALINAS
KEO	ODIENNE
HRL	HARLINGEN
BLK	BLACKPOOL
MEX	MEXICO CITY
YQN	NAKINA
YME	MATANE
YVB	BONAVENTURE
RCE	ROCHE HARBOR
RNE	ROANNE
MJV	MURCIA
GIB	GIBRALTAR
RVN	ROVANIEMI
NIB	NIKOLAI
EDI	EDINBURGH
TUR	TUCURUI
NTX	NATUNA
UDD	PALM SPRINGS BERMUDA DUNES
KMH	KURUMAN
LGU	LOGAN
TFL	TEOFILO OTONI
TRC	TORREON
LAQ	BEIDA
XKS	KASABONIKA
IGB	INGENIERO JACOBACCI
OTI	MOROTAI ISLAND
ZTM	SHAMATTAWA
BGY	MILAN ORIO AL SERIO
TSJ	TSUSHIMA
GBG	GALESBURG
AGC	PITTSBURGH ALLEGHENY COUNTY AP
TUM	TUMUT
MYA	MORUYA
DUR	DURBAN
CMK	CLUB MAKOKOLA
RPN	ROSH PINA
SCU	SANTIAGO DE CUBA
VGT	LAS VEGAS
MGA	MANAGUA
GGW	GLASGOW
KPV	PERRYVILLE
YPJ	AUPALUK
DIB	DIBRUGARH
GWD	GWADAR
CRG	JACKSONVILLE CRAIG
PEQ	PECOS
GOZ	GORNA ORJAHOVICA
OMB	OMBOUE
YLC	KIMMIRUT/LAKE HARBOUR
RGL	RIO GALLEGOS
SWX	SHAKAWE
KOV	KOKCHETAV
IFL	INNISFAIL
OWD	NORWOOD
IXR	RANCHI
KKJ	KITAKYUSHU
KEA	KEISAH
YFA	FORT ALBANY
MJN	MAJUNGA
HOR	HORTA
YVP	KUUJJUAQ
HVB	HERVEY BAY
UAI	SUAI
SKQ	SEKAKES
CRV	CROTONE
GDL	GUADALAJARA
KWL	GUILIN
NAL	NALCHIK
PIX	PICO ISLAND
ZBY	SAYABOURY
GCK	GARDEN CITY
JAG	JACOBABAD
ZPB	SACHIGO LAKE
YYA	BIG BAY YACHT CLUB
BTM	BUTTE
BJD	BAKKAFJORDUR
MKN	MALEKOLON
RLG	WEITENDORF
TGN	TRARALGON
AGA	AGADIR
MLX	MALATYA
DUD	DUNEDIN
YAA	ANAHIM LAKE
MNT	MINTO
KWY	KIWAYU
GDQ	GONDAR
YMT	CHIBOUGAMAU
WKR	WALKERS CAY
STA	STAUNING
PVO	PORTOVIEJO
NOV	HUAMBO
HNL	HONOLULU
AUC	ARAUCA
JUI	JUIST
AOR	ALOR SETAR
XMN	XIAMEN
RAL	RIVERSIDE
PEH	PEHUAJO
LRM	LA ROMANA
ADY	ALLDAYS
FRE	FERA ISLAND
OTP	BUCHAREST
DRD	DORUNDA STATION
PBZ	PLETTENBERG BAY
YPD	PARRY SOUND
TTG	TARTAGAL
YOL	YOLA
SEZ	MAHE ISLAND
MMF	MAMFE
EIN	EINDHOVEN
LUL	LAUREL
KAO	KUUSAMO
MLZ	MELO
OSI	OSIJEK
CXF	COLDFOOT
PSI	PASNI
BMO	BHAMO
CMH	COLUMBUS
MMH	MAMMOTH LAKES
PRX	PARIS
LKL	LAKSELV
TGH	TONGOA
MPD	MIRPUR KHAS
MAF	MIDLAND/ODESSA
MYV	MARYSVILLE
NOR	NORDFJORDUR
FWA	FORT WAYNE
JAB	JABIRU
WLG	WELLINGTON
OCN	OCEANSIDE
KAN	KANO
GOR	GORE
POP	PUERTO PLATA
TNC	TIN CITY
LIH	KAUAI ISLAND
HGD	HUGHENDEN
JMS	JAMESTOWN
TRB	TURBO
HSL	HUSLIA
ADL	ADELAIDE
UIT	JALUIT ISLAND
PLZ	PORT ELIZABETH
OOM	COOMA
FDE	FORDE
AWA	AWASSA
DNV	DANVILLE
ATU	ATTU ISLAND
KDV	KANDAVU
BEK	RAE BARELI
RBR	RIO BRANCO
MYG	MAYAGUANA
THO	THORSHOFN
ABU	ATAMBUA
CYI	CHIAYI
YSZ	SQUIRREL COVE
RHO	RHODES
SWD	SEWARD
KAI	KAIETEUR
MCG	MCGRATH
FDF	FORT DE FRANCE
WWY	WEST WYALONG
SYB	SEAL BAY
PNC	PONCA CITY
SNP	SAINT PAUL ISLAND
NDA	BANDANAIRA
LAE	LAE
MCI	KANSAS CITY
MTW	MANITOWOC
PPP	PROSERPINE
TST	TRANG
KWZ	KOLWEZI
BJK	BENJINA
NUB	NUMBULWAR
ACI	ALDERNEY
INV	INVERNESS
MWK	MATAK
NRL	NORTH RONALDSAY
LEB	LEBANON
ELI	ELIM
PPS	PUERTO PRINCESA
WMR	MANANARA
YEY	AMOS
LIE	LIBENGE
SVI	SAN VICENTE DEL CAGUAN
ERI	ERIE
SEL	SEOUL
PHC	PORT HARCOURT
CRI	CROOKED ISLAND
HUS	HUGHES
TPS	TRAPANI
EWN	NEW BERN
GEN	OSLO GARDERMOEN APT old
FUB	FULLEBORN
MYI	MURRAY ISLAND
ZFD	FOND DU LAC
IXW	JAMSHEDPUR
PAE	EVERETT
JDO	JUAZEIRO DO NORTE
FKQ	FAK FAK
VEE	VENETIE
RAH	RAFHA
AJF	AL-JOUF
SMR	SANTA MARTA
MZC	MITZIC
UET	QUETTA
BLQ	BOLOGNA
SHD	STAUNTON
CEK	CHELYABINSK
IAM	IN AMENAS
OES	SAN ANTONIO OESTE
HOG	HOLGUIN
GXY	GREELEY
BIK	BIAK
HOU	HOUSTON
YBI	BLACK TICKLE
ULN	ULAN BATOR
YTO	TORONTO
KEH	KENMORE
FID	FISHERS ISLAND
JOS	JOS
OLI	OLAFSVIK
PYE	PENRHYN ISLAND
REC	RECIFE
BPG	BARRA DO GARCAS
SKP	SKOPJE
SUF	LAMEZIA TERME
FNL	FORT COLLINS
TZA	BELIZE CITY
KKN	KIRKENES
KPN	KIPNUK
KEK	EKWOK
YRT	RANKIN INLET
ACA	ACAPULCO
MCN	MACON
NON	NONOUTI
ICA	ICABARU
MCD	MACKINAC ISLAND
CEC	CRESCENT CITY
MOQ	MORONDAVA
TAS	TASHKENT
TPE	TAIPEI
MSN	MADISON
RCL	REDCLIFFE
WTE	WOTJE ISLAND
NIG	NIKUNAU
GRO	GERONA
SNU	SANTA CLARA
KWK	KWIGILLINGOK
JAX	JACKSONVILLE
SGD	SONDERBORG
TYS	KNOXVILLE
TZN	SOUTH ANDROS
MLB	MELBOURNE
YGE	GORGE HARBOR
RPR	RAIPUR
BAV	BAOTOU
VNS	VARANASI
CGP	CHITTAGONG
YEL	ELLIOT LAKE
IGG	IGIUGIG
WAW	WARSAW / OKECIE
SHY	SHINYANGA
SYM	SIMAO
YPB	PORT ALBERNI
PIS	POITIERS
MSG	MATSAILE
BTZ	BURSA
SPB	SAINT THOMAS SPB
KNJ	KINDAMBA
PPE	PUERTO PENASCO
ORD	CHICAGO O'HARE INT APT
UAQ	SAN JUAN
WDG	ENID
TCW	TOCUMWAL
YGB	GILLIES BAY
XBL	BUNO BEDELLE
BKC	BUCKLAND
BRV	BREMERHAVEN
PMA	PEMBA
BTS	BRATISLAVA
MLN	MELILLA
BOB	BORA BORA
BCB	BLACKSBURG
CGH	SAO PAULO CONGONHAS
YGD	Goderich, Ontario
GEG	SPOKANE
ICT	WICHITA
CDB	COLD BAY
LGQ	LAGO AGRIO
RRG	RODRIGUES ISLAND
FPY	PERRY
UKI	UKIAH
BRN	BERNE
YTX	TELEGRAPH CREEK
ELU	EL OUED
FNC	FUNCHAL
DND	DUNDEE
PBU	PUTAO
LYX	LYDD
PKY	PALANGKARAYA
LBV	LIBREVILLE
WGP	WAINGAPU
LWO	LVOV
FLI	FLATEYRI
KMA	KEREMA
PNL	PANTELLERIA
LIF	LIFOU
NCE	NICE
TAT	TATRY/POPRAD
YOD	COLD LAKE
TFN	TENERIFE
MUR	MARUDI
WNA	NAPAKIAK
WHL	WELSHPOOL
MCW	MASON CITY
KHV	KHABAROVSK
YOW	OTTAWA
CVQ	CARNARVON
YSK	SANIKILUAQ
AZA	WILLIAMS GATEWAY AIRPORT
UKU	NUKU
AGP	MALAGA
WNP	NAGA
YTA	PEMBROKE
QUN	CHUN CHON CITY
WEL	WELKOM
MRP	MARLA
TCO	TUMACO
JVA	ANKAVANDRA
YYT	ST. JOHN'S,  NEWFOUNDLAND
KGU	KENINGAU
JAH	AUBAGNE
HNK	HINCHINBROOKE ISLAND
SDQ	SANTO DOMINGO
DIL	DILI
LMR	LIME ACRES
TNE	TANEGA SHIMA
MZF	MZAMBA
ABA	ABAKAN
LNB	LAMEN BAY
ORS	ORPHEUS ISLAND RESORT
XIL	XILINHOT
BNE	BRISBANE
GUQ	GUANARE
PTL	PORT ARMSTRONG
NOZ	NOVOKUZNETSK
PSP	PALM SPRINGS
ROA	ROANOKE
MVT	MATAIVA
HBX	HUBLI
UEE	QUEENSTOWN
ZVK	SAVANNAKHET
KMQ	KOMATSU
MOB	MOBILE
PDN	PARNDANA
NSA	NOOSA
VST	VASTERAS
MLW	MONROVIA
NNG	NANNING
BNP	BANNU
PGA	PAGE
RMK	RENMARK
MTY	MONTERREY
KEL	KIEL
YTQ	TASIUJUAQ
AKL	AUCKLAND
JJU	JULIANEHAAB
HEL	HELSINKI
LZH	LIUZHOU
KRL	KORLA
PKO	PARAKOU
SDV	TEL AVIV
KIV	KISHINEV
KSA	KOSRAE
SLK	SARANAC LAKE
TAO	QINGDAO
YBC	BAIE COMEAU
SLN	SALINA
AND	ANDERSON
YHF	HEARST
NHV	NUKU HIVA
SSR	SARA
KMG	KUNMING
KGG	KEDOUGOU
DMB	DZHAMBUL
RDC	REDENCAO
CHO	CHARLOTTESVILLE
KRI	KIKORI
BSA	BOSSASO
YBT	BROCHET
ZIS	SEIS BUS STATION
YQG	WINDSOR
LPP	LAPPEENRANTA
YXT	TERRACE
EVG	SVEG
PLW	PALU
SNN	SHANNON
BEO	NEWCASTLE BELMONT
YQY	SYDNEY
OBK	NORTHBROOK
THE	TERESINA
ZFA	FARO
VMU	BAIMURU
THN	TROLLHATTAN
GHC	GREAT HARBOUR CAY
VME	VILLA MERCEDES
SRJ	SAN BORJA
TMT	TROMBETAS
MRA	MISURATA
RVO	REIVILO
HSI	HASTINGS
DGO	DURANGO
SPR	SAN PEDRO
KLG	KALSKAG
KKZ	KOH KONG
AFA	SAN RAFAEL
PRC	PRESCOTT
PSJ	POSO
GMN	GREYMOUTH
LGX	LUGH GANANE
ASM	ASMARA
KOU	KOULAMOUTOU
IDY	ILE D'YEU
WAI	ANTSOHIHY
YNR	FORT MACKAY
IOU	ILE OUEN
IXJ	JAMMU
LOE	LOEI
YQM	MONCTON
XGR	KANGIQSUALUJJUAQ
DIE	ANTSIRANANA
YLR	LEAF RAPIDS
PEI	PEREIRA
AGH	HELSINGBORG
MBM	MKAMBATI
DOR	DORI
CBO	COTABATO
SVD	SAINT VINCENT
LRB	LERIBE
BJL	BANJUL
JMO	JOMSOM
JAQ	JACQUINOT BAY
NNK	NAKNEK
YRD	DEAN RIVER
OGZ	ORDZHONIKIDZE
KEE	KELLE
LOS	LAGOS
KKW	KIKWIT
SFB	SANFORD
AAS	APALAPSILI
YBV	BERENS RIVER
NAG	NAGPUR
RDD	REDDING
BHC	BULLHEAD CITY
YNG	YOUNGSTOWN
ETZ	METZ
FAO	FARO
HSV	HUNTSVILLE
UBI	BUIN
SUS	Spirit Of St Louis
FLN	FLORIANOPOLIS
MTI	MOSTEIROS
LMT	KLAMATH FALLS
YXK	RIMOUSKI
RSX	ROUSES POINT
HUY	HUMBERSIDE
YDO	DOLBEAU
SHZ	SESHUTES
CYG	CORRYONG
SRG	SEMARANG
FUK	FUKUOKA
MIS	MISIMA ISLAND
IXC	CHANDIGARH
DAB	DAYTONA BEACH
THU	THULE
CAC	CASCAVEL
VXO	VAXJO
SHG	SHUNGNAK
OSZ	KOSZALIN / ZEGRZE POMORSKIE
MYQ	MYSORE
ULY	ULYANOVSK
SAZ	SASSTOWN
FAM	FARMINGTON
PEK	BEIJING
MTV	MOTA LAVA
TSB	TSUMEB
TNB	TANAH GROGOT
DRE	DRUMMOND ISLAND
POS	PORT OF SPAIN
LDY	LONDONDERRY
MEM	MEMPHIS
ASO	ASOSA
KGI	KALGOORLIE
QBC	BELLA COOLA
ODY	OUDOMXAY
YUD	UMIUJAQ
AHB	ABHA
ANE	ANGERS
ORJ	ORINDUIK
ALW	WALLA WALLA
NEV	NEVIS
ATK	ATQASUK
JUL	JULIACA
YDP	NAIN
MZI	MOPTI
SRR	STRADBROKE ISLAND
NMU	NAMU
SJU	SAN JUAN
PPJ	PULAU PANJANG
TSS	NEW YORK
MJZ	MIRNYJ
IXV	ALONG
FRD	FRIDAY HARBOR
RVK	ROERVIK
SSQ	LA SARRE
KLQ	KELUANG
RAV	CRAVO NORTE
PMF	PARMA
JJI	JUANJUI
CTH	COATESVILLE
YZS	CORAL HARBOUR
TDD	TRINIDAD
COH	COOCH BEHAR
JAA	JALALABAD
KIQ	KIRA
WGC	WARANGAL
MKL	JACKSON
HWD	HAYWARD
NRD	NORDERNEY
SZZ	SZCZECIN / GOLENIOW
RIC	RICHMOND
MAT	MATADI
MNK	MAIANA
BUR	BURBANK
BMK	BORKUM
YXZ	WAWA
ZMT	MASSET
GRI	GRAND ISLAND
LUQ	SAN LUIS
EAU	EAU CLAIR
ARR	ALTO RIO SENGUERR
LUW	LUWUK
PVR	PUERTO VALLARTA
NOO	NAORO
PSM	PORTSMOUTH PEASE INTERNATIONAL
SSS	SIASSI
SAM	SALAMO
CLM	PORT ANGELES
KUC	KURIA
PKC	PETROPAVLOVSK-KAMCHATSKY
PAS	PAROS
SOO	SODERHAMN
EMN	NEMA
TAP	TAPACHULA
GER	NUEVA GERONA
NTE	NANTES
ISN	WILLISTON
WKJ	WAKKANAI
OIR	OKUSHIRI
KYO	TAMPA
MIF	MONAHANS
MKE	MILWAUKEE
HFT	HAMMERFEST
GRU	SAO PAULO GUARULHOS
IMB	IMBAIMADAI
GII	SIGUIRI
WDH	WINDHOEK
JLD	LANDSKRONA
LFT	LAFAYETTE
GXG	NEGAGE
TNR	ANTANANARIVO
HYR	HAYWARD
SQN	SANANA
QWP	WINTER PARK
CKV	CLARKSVILLE
RFP	RAIATEA ISLAND
JAT	JABAT
INL	INTERNATIONAL FALLS
TBN	FORT LEONARD WOOD
BRI	BARI
SNJ	SAN JULIAN
GMI	GASMATA
IWD	IRONWOOD
KGK	KOLIGANEK
LCR	LA CHORRERA
ABV	ABUJA
WHR	VAIL AVON
TLV	TEL AVIV
LET	LETICIA
EAP	BASLE/MULHOUSE
KAJ	KAJAANI
TKN	TOKUNOSHIMA
CTU	CHENGDU
DEL	DELHI
RDE	MERDEY
HSP	HOT SPRINGS
KVA	KAVALA
SPW	SPENCER
WSX	WESTSOUND
AHD	ARDMORE DOWNTOWN APT
UFA	UFA
BAY	BAIA MARE
SGJ	SAGARAI
AGF	AGEN
LST	LAUNCESTON
HON	HURON
DTE	DAET
MUA	MUNDA
DUC	DUNCAN
OSL	OSLO GARDERMOEN APT
EOI	EDAY
SID	SAL
ZBN	BOLZANO
GMA	GEMENA
YFB	IQALUIT
PUW	PULLMAN/MOSCOW
YAM	SAULT SAINTE MARIE
WLH	WALAHA
SOC	SOLO CITY
JRA	NEW YORK WEST
CZM	COZUMEL
GOV	GOVE
VRC	VIRAC
MZX	MENA
HDB	HEIDELBERG
FFT	FRANKFORT
GKE	GEILENKIRCHEN
MLE	MALE
MAZ	MAYAGUEZ
PEE	PERM
MKC	KANSAS CITY
YSI	SAN SOUCI
HGN	MAE HONG SON
NFO	NIUAFO'OU
AXB	ALEXANDRIA BAY
TLT	TULUKSAK
OTH	NORTH BEND
IXY	KANDLA
CRK	LUZON ISLAND
MSD	MOUNT PLEASANT
AMM	AMMAN
HIR	HONIARA
ZCO	TEMUCO
YLW	KELOWNA
TGT	TANGA
YPN	PORT MENIER
GUH	GUNNEDAH
FMY	FORT MYERS
MOF	MAUMERE
GTF	GREAT FALLS
MPT	MALIANA
NTM	MIRACEMA DO NORTE
FRM	FAIRMONT
VGA	VIJAYAWADA
DFW	DALLAS/FORT WORTH
YLH	LANSDOWNE HOUSE
JHC	GARDEN CITY
GPZ	GRAND RAPIDS
XGG	GOROM-GOROM
HPN	WESTCHESTER CNTY/WHITE PLAINS
GLC	GELADI
JOP	JOSEPHSTAAL
YTE	CAPE DORSET
ZZU	MZUZU
KWA	KWAJALEIN
HAN	HANOI
TIQ	TINIAN ISLAND
UME	UMEA
BBR	BASSE TERRE
MNM	MENOMINEE
OCC	COCA
FCA	KALISPELL
XMC	MALLACOOTA
CLY	CALVI
RBF	BIG BEAR
LYA	LUOYANG
KMK	MAKABANA
MJA	MANJA
ATH	ATHENS
BEF	BLUEFIELDS
MLO	MILOS
JER	JERSEY
CJL	CHITRAL
HOC	KOMAKO
CHI	CHICAGO
BIO	BILBAO
CFO	CONFREZA
MYE	MIYAKE JIMA
SBP	SAN LUIS OBISPO
BPC	BAMENDA
SBO	SALINA
PIH	POCATELLO
PUU	PUERTO ASIS
KXA	KASAAN
CXP	CILACAP
PVU	PROVO
INF	IN GUEZZAM
TUI	TURAIF
YIK	IVUJIVIK
LTA	TZANEEN
ANK	ANKARA
SUB	SURABAYA
AVX	CATALINA ISLAND
ZOF	OCEAN FALLS
VIE	VIENNA
NDD	SUMBE
KMU	KISMAYU
REW	REWA
YAY	SAINT ANTHONY
BIY	BISHO
KEI	KEPI
VXE	SAO VICENTE
HFN	HOFN
TDB	TETABEDI
ABK	KABRI DAR
TMO	TUMEREMO
CHU	CHUATHBALUK
ICK	NIEUW NICKERIE
IVL	IVALO
LEH	LE HAVRE
MHH	MARSH HARBOUR
SMV	SAINT MORITZ
CCZ	CHUB CAY
BON	BONAIRE
LAJ	LAGES
CAU	CARUARU
CFN	DONEGAL
XGL	GRANVILLE LAKE
LZC	LAZARO CARDENAS
VRN	VERONA
SRZ	SANTA CRUZ
RKD	ROCKLAND
RSH	RUSSIAN MISSION
WHK	WHAKATANE
LHA	LAHR
VPS	VALPARAISO
WWD	WILDWOOD
AYQ	AYERS ROCK
IKT	IRKUTSK
MBU	MBAMBANAKIRA
NDK	NAMORIK ISLAND
MUN	MATURIN
ATC	ARTHUR'S TOWN
GYY	CHICAGO GARY
MCO	ORLANDO
GTE	GROOTE EYLANDT
ILY	ISLAY
BYW	BLAKELY ISLAND
TJA	TARIJA
LSS	TERRE-DE-HAUT
ISK	NASIK
LCV	LUCCA
HUT	HUTCHINSON
BXS	BORREGO SPRINGS
PAG	PAGADIAN
BIC	BIG CREEK
AMH	ARBA MINTCH
NER	NERYUNGRI
GUA	GUATEMALA CITY
JTR	THIRA
POX	PONTOISE
OGR	BONGOR
ROC	ROCHESTER
TIX	TITUSVILLE
LMX	LOPEZ DE MICAY
YCG	CASTLEGAR
RYO	RIO TURBIO
ALL	ALBENGA
OKN	OKONDJA
YDI	DAVIS INLET
TUD	TAMBACOUNDA
VIC	VICENZA
POA	PORTO ALEGRE
CFG	CIENFUEGOS
BDH	BANDAR LENGEH
HPB	HOOPER BAY
ARS	ARAGARCAS
AVL	ASHEVILLE
FHU	FORT HUACHUCA/SIERRA VISTA
BOG	BOGOTA
AUS	AUSTIN
RMI	RIMINI
COU	COLUMBIA
LUO	LUENA
PNZ	PETROLINA
CKG	CHONGQING
SRV	STONY RIVER
GVA	GENEVA
ZGF	GRAND FORKS
DSM	DES MOINES
HYL	HOLLIS
YZH	SLAVE LAKE, ALBERTA
EKE	EKEREKU
FGI	APIA FAGALI'I APT
BUY	BUNBURY
ART	WATERTOWN
SCZ	SANTA CRUZ ISLAND
CBH	BECHAR
YCH	MIRAMICHI  (CHATHAM)
SAN	SAN DIEGO
YPW	POWELL RIVER
XIC	XICHANG
APZ	ZAPALA
WBB	STEBBINS
GLT	GLADSTONE
URY	GURAYAT
CPE	CAMPECHE
HYD	HYDERABAD
TPH	TONOPAH
LRD	LAREDO
YFS	FORT SIMPSON
IVR	INVERELL
TTA	TAN TAN
TXM	TEMINABUAN
AAT	ALTAY
SMW	SMARA
VQQ	CECIL AIRPORT
IRI	IRINGA
DUG	DOUGLAS
LBI	ALBI
NEG	NEGRIL
AUK	ALAKANUK
IQQ	IQUIQUE
ORB	OREBRO
BNT	BUNDI
OSY	NAMSOS
LWK	SHETLAND ISLANDS LERWICK/TINGW
SAL	SAN SALVADOR
SYZ	SHIRAZ
YQH	WATSON LAKE
YIO	POND INLET
RDZ	RODEZ
MIE	MUNCIE
MAB	MARABA
STX	SAINT CROIX
CRD	COMODORO RIVADAVIA
BVH	VILHENA
LES	LESOBENG
LAP	LA PAZ
OFJ	OLAFSFJORDUR
GEW	GEWOYA
KSE	KASESE
YOG	OGOKI
DLY	DILLONS BAY
KMP	KEETMANSHOOP
GWL	GWALIOR
CLN	CAROLINA
WIC	WICK
NLK	NORFOLK ISLAND
YPL	PICKLE LAKE
GGR	GAROE
PPT	PAPEETE
TUK	TURBAT
KNS	KING ISLAND
KZN	KAZAN
CRQ	CARAVELAS
ATI	ARTIGAS
LGZ	LEGUIZAMO
MYF	SAN DIEGO
KWG	KRIVOY ROG
KVC	KING COVE
YFD	BRANTFORD,  ONTARIO
JPT	HOUSTON PARK TEN
GOH	NUUK
THK	THAKHEK
BHO	BHOPAL
OTG	WORTHINGTON MUNICIPAL
MXJ	MINNA
NEC	NECOCHEA
DUT	DUTCH HARBOR
SUT	SUMBAWANGA
ABH	ALPHA
ZWA	ANDAPA
GSO	GREENSBORO
PXM	PUERTO ESCONDIDO
IGO	CHIGORODO
CJS	CIUDAD JUAREZ
NJC	NIZHNEVARTOVSK
OKQ	OKABA
YTZ	TORONTO ISLAND
PIB	LAUREL PINE BELT
RIA	SANTA MARIA
SFO	SAN FRANCISCO
JRS	JERUSALEM
CGF	CLEVELAND CUYAHOGA
EKI	ELKHART
MXT	MAINTIRANO
YTF	ALMA
AAR	AARHUS
PDV	PLOVDIV
ACK	NANTUCKET
HUX	HUATULCO
IXZ	PORT BLAIR
HAV	HAVANA
CIP	CHIPATA
YYY	MONT JOLI
OZH	ZAPOROZHYE
FBE	FRANCISCO BELTRAO
PAZ	POZA RICA
BXI	BOUNDIALI
MGM	MONTGOMERY
NDU	RUNDU
GIC	BOIGU ISLAND
YTP	TOFINO SPB
YHD	DRYDEN
PTA	PORT ALSWORTH
ZNG	NEGGINAN
DJB	JAMBI
BQT	BREST
TEQ	TEKIRDAG
SIO	SMITHTON
TKK	TRUK
BTU	BINTULU
SDK	SANDAKAN
LGB	LONG BEACH
PGX	PERIGUEUX
TSR	TIMISOARA
MPB	MIAMI SPB
DJE	DJERBA
HAD	HALMSTAD
MOA	MOA
TPQ	TEPIC
AUJ	AMBUNTI
LYS	LYON
RUI	RUIDOSO
YWB	KANGIQSUJUAQ
MUC	MUNICH
RSD	ROCK SOUND
YPR	PRINCE RUPERT
WMA	MANDRITSARA
SRY	SARY
YNC	WEMINDJI
FOO	NUMFOOR
OMR	ORADEA
NAW	NARATHIWAT
KTB	THORNE BAY
YSM	FORT SMITH
EPL	EPINAL
SCQ	SANTIAGO DE COMPOSTELA
VFA	VICTORIA FALLS
IPC	EASTER ISLAND
BUG	BENGUELA
PTU	PLATINUM
BMP	BRAMPTON ISLAND
CFA	COFFEE POINT
GHB	GOVERNORS HARBOUR
BIH	BISHOP
ZGS	GETHSEMANI
PAH	PADUCAH
BNJ	BONN
BAK	BAKU
YQX	GANDER
PYH	PUERTO AYACUCHO
BMG	BLOOMINGTON
IXK	KESHOD
TEH	TETLIN
LMY	LAKE MURRAY
BCG	BEMICHI
BXO	BISSAU
YER	FORT SEVERN
OCV	OCANA
HEA	HERAT
YKF	KITCHENER/WATERLOO
BNB	BOENDE
XLS	SAINT LOUIS
RVA	FARAFANGANA
RLD	RICHLAND
NUS	NORSUP
SHM	NANKI SHIRAHAMA
EEN	KEENE
BCZ	BICKERTON ISLAND
ZEM	EASTMAIN
BKU	BETIOKY
PKA	NAPASKIAK
GLN	GOULIMIME
STT	SAINT THOMAS
MGQ	MOGADISHU
YPI	PORT SIMPSON
TLF	TELIDA
AMR	ARNO
TUL	TULSA
SON	ESPIRITU SANTO
MNY	MONO
CFE	CLERMONT-FERRAND
IPW	IPSWICH
SCE	STATE COLLEGE
CDG	PARIS CHARLES DE GAULLE APT
GVR	GOVERNADOR VALADARES
SJJ	SARAJEVO
CNM	CARLSBAD
MDV	MEDOUNEU
SNA	ORANGE COUNTY
KPK	PARKS
BTW	BATU LICIN
HDA	HIDDEN FALLS
OHR	WYK AUF FOHR
EDB	ELDEBBA
NBX	NABIRE
GNU	GOODNEWS BAY
TDL	TANDIL
UAS	SAMBURU
GJR	GJOGUR
HJR	KHAJURAHO
BJA	BEJAIA
VHC	SAURIMO
DXB	DUBAI
AMD	AHMEDABAD
HKB	HEALY LAKE
YNK	NOOTKA SOUND
PTP	POINTE-A-PITRE
TLN	TOULON
SZH	SENIPAH
VOZ	VORONEZH
LEA	LEARMONTH
YSL	SAINT LEONARD
FAR	FARGO
HKD	HAKODATE
YSO	POSTVILLE
JUV	UPERNAVIK
WPM	WIPIM
MFC	MAFETENG
ALO	WATERLOO
PSZ	PUERTO SUAREZ
EWR	NEW YORK,   NEWARK
TGI	TINGO MARIA
RNR	ROBINSON RIVER
HBT	HAFR ALBATIN
BVB	BOA VISTA
SLX	SALT CAY
NAO	NANCHONG
HMO	HERMOSILLO
TEU	TE ANAU
YDG	DIGBY
FFM	FERGUS FALLS
TBH	TABLAS
JST	JOHNSTOWN
KLH	KOLHAPUR
CID	CEDAR RAPIDS
TBT	TABATINGA
HMR	HAMAR
TTN	TRENTON
LCA	LARNACA
MWU	MUSSAU
RNJ	YORONJIMA
LFO	KELAFO
AUG	AUGUSTA
BVI	BIRDSVILLE
GOU	GAROUA
BLF	BLUEFIELD
NOU	NOUMEA
LBU	LABUAN
CTL	CHARLEVILLE
TIA	TIRANA
NYN	NYNGAN
HBH	HOBART BAY
KMO	MANOKOTAK
AHT	AMCHITKA
HGL	HELGOLAND
SHB	NAKASHIBETSU
CCV	CRAIG COVE
HFD	HARTFORD BRAINARD
CDR	CHADRON
ISA	MOUNT ISA
ABI	ABILENE
YTJ	TERRACE BAY
KOK	KOKKOLA/PIETARSAARI
CMA	CUNNAMULLA
OUE	OUESSO
HYG	HYDABURG
HCA	BIG SPRING
SKB	SAINT KITTS
SJD	SAN JOSE DEL CABO (MX)
YGV	HAVRE SAINT PIERRE
EGA	ENGATI
HPV	KAUAI ISLAND PRINCEVILLE
OYA	GOYA
SPZ	SPRINGDALE
VIS	VISALIA
NEW	NEW ORLEANS
ISP	ISLIP
YNO	NORTH SPIRIT LAKE
AKS	AUKI
PNI	POHNPEI
GNV	GAINESVILLE
DOD	DODOMA
YTL	BIG TROUT LAKE
BMI	BLOOMINGTON-NORMAL
BRO	BROWNSVILLE
DNR	DINARD
BSP	BENSBACH
ZER	ZERO
PRS	PARASI
SVL	SAVONLINNA
FDU	BANDUNDU
GDN	GDANSK / REBIECHOWO
UTP	UTAPAO
PYX	PATTAYA
TLE	TULEAR
JDM	MIAMI
WAM	AMBATONDRAZAKA
YTK	TULUGAK
GUS	Grissom Aeroplex
CRC	CARTAGO
JMC	SAUSALITO
GYE	GUAYAQUIL
LND	LANDER
YWY	WRIGLEY
IUE	NIUE
YDF	DEER LAKE
KTY	TERROR BAY
SUH	SUR
BLT	BLACKWATER
MBL	MANISTEE
LTO	LORETO
PUK	PUKARUA
YGZ	GRISE FIORD
RLP	ROSELLA PLAINS
KFA	KIFFA
LEX	LEXINGTON
ZLT	LA TABATIERE
DVL	DEVILS LAKE
COD	CODY
LRS	LEROS
CKX	CHICKEN
YIV	ISLAND LAKE/GARDEN HILL
PZH	ZHOB
PTI	PORT DOUGLAS
WOK	WONKEN
URT	SURAT THANI
ZTH	ZAKYNTHOS
YHO	HOPEDALE
YUM	YUMA
KSF	KASSEL
BGO	BERGEN
PEA	PENNESHAW
NPE	NAPIER/HASTINGS
VAA	VAASA
TEX	TELLURIDE
WKN	WAKUNAI
TWB	TOOWOOMBA
ANI	ANIAK
MXX	MORA
FAJ	FAJARDO
WLB	LABOUCHERE BAY
BSQ	BISBEE
KUN	KAUNAS
AUX	ARAGUAINA
DEZ	DEIREZZOR
RME	GRIFFISS AFB, ROME, NEW YORK
ALV	ANDORRA LA VELLA
BHH	BISHA
GLK	GALCAIO
YVZ	DEER LAKE
IBE	IBAGUE
CIT	CHIMKENT
FRG	FARMINGDALE
YOC	OLD CROW
KOB	KOUTABA
SOY	STRONSAY
SJV	SAN JAVIER
VBY	VISBY
NEU	SAM NEUA
OVD	ASTURIAS
YMM	FORT MCMURRAY
AVW	TUCSON AVRA VALLEY APT
FTX	OWANDO
UNV	ZZZ
APV	APPLE VALLEY
LRT	LORIENT
AGZ	AGGENEYS
MKS	MEKANE SELAM
YNJ	YANJI
FUJ	FUKUE
TIS	THURSDAY ISLAND
HSH	LAS VEGAS
VDM	VIEDMA
AUA	ARUBA
YKZ	TORONTO (Buttonville)
SXR	SRINAGAR
ROP	ROTA
AIZ	KAISER/LAKE OF THE OZARKS
LAH	LABUHA
QKS	KEYSTONE
PSR	PESCARA
EXI	EXCURSION
LPX	LIEPAYA
NIO	NIOKI
YAL	ALERT BAY
OPI	OENPELLI
SBA	SANTA BARBARA
CRX	CORINTH
MVQ	MOGILEV
YKT	KLEMTU
PTH	PORT HEIDEN
GOI	GOA
YZT	PORT HARDY
KWN	QUINHAGAK
LHS	LAS HERAS
PNO	PINOTEPA
PHZ	PHI PHI ISLAND
EAA	EAGLE
RRS	ROROS
TUN	TUNIS
JSI	SKIATHOS
HDF	HERINGSDORF
SXK	SAUMLAKI
YBX	BLANC SABLON
CHS	CHARLESTON
NAN	NADI
ZTA	TUREIA
BKI	KOTA KINABALU
POM	PORT MORESBY
KES	KELSEY
KTW	KATOWICE / PYRZOWICE
OIT	OITA
YWM	WILLIAMS HARBOUR
IGR	IGUAZU
TKA	TALKEETNA
HUF	TERRE HAUTE
CBN	CIREBON
CJB	COIMBATORE
TPA	TAMPA
YXC	CRANBROOK
XSC	SOUTH CAICOS
APN	ALPENA
YHZ	HALIFAX
ROK	ROCKHAMPTON
ASC	ASCENSION
MTH	MARATHON
ERU	ERUME
TRF	SANDEFJORD
BFN	BLOEMFONTEIN
HRG	HURGHADA
AOL	PASO DE LOS LIBRES
JHM	KAPALUA
PKN	PANGKALANBUN
MDG	MUDANJIANG
PHX	PHOENIX
DMD	DOOMADGEE MISSION
MYP	MARY
YAB	ARCTIC BAY
TAC	TACLOBAN
BJI	BEMIDJI
SGN	HO CHI MINH CITY
EVN	YEREVAN
PJS	PORT SAN JUAN
KWI	KUWAIT
DLC	DALIAN
YQU	GRANDE PRAIRIE
TEE	TBESSA
TOD	TIOMAN
KDR	KANDRIAN
CMQ	CLERMONT
SLL	SALALAH
ATN	NAMATANAI
HHZ	HIKUERU
EHL	EL BOLSON
RJI	RAJOURI
ZLO	MANZANILLO
KVB	SKOVDE
KOX	KOKONAO
KOJ	KAGOSHIMA
LWE	LEWOLEBA
YVM	BROUGHTON ISLAND/QIKIQTARJUAG
MFE	MCALLEN
MAX	MATAM
LNV	LONDOLOVIT
GON	NEW LONDON/GROTON
BYU	BAYREUTH
MAR	MARACAIBO
GRR	GRAND RAPIDS
YCK	COLVILLE LAKE
REK	REYKJAVIK
NKG	NANJING
DRS	DRESDEN
PUG	PORT AUGUSTA
CHC	CHRISTCHURCH
BKL	CLEVELAND BURKE LAKEFRONT
TRS	TRIESTE
HOK	HOOKER CREEK
PPW	PAPA WESTRAY
DTT	DETROIT
YBA	BANFF
KSJ	KASOS ISLAND
BVA	BEAUVAIS
TUU	TABUK
NTY	SUN CITY
KLW	KLAWOCK
DAM	DAMASCUS
PDZ	PEDERNALES
ANU	ANTIGUA
IOR	INISHMORE
DIY	DIYARBAKIR
AXT	AKITA
YBE	URANIUM CITY
YPY	FORT CHIPEWYAN
BST	BOST
PKK	PAKOKKU
OBX	OBO
LLW	LILONGWE
BDB	BUNDABERG
FEZ	FEZ
BHN	BEIHAN
WNS	NAWABSHAH
CPB	CAPURGANA
LEJ	LEIPZIG
WRY	WESTRAY
PBN	PORTO AMBOIM
CEF	CHICOPEE
ZAM	ZAMBOANGA
IPI	IPIALES
KRO	KURGAN
EDA	EDNA BAY
WRO	WROCLAW / STRACHOWICE
OKE	OKINO ERABU
CAE	COLUMBIA
MBO	MAMBURAO
LPW	LITTLE PORT WALTER
CAQ	CAUCASIA
GUX	GUNA
SLH	SOLA
ISG	ISHIGAKI
RAO	RIBEIRAO PRETO
WWK	WEWAK
TGO	TONGLIAO
FYN	FUYUN
BKM	BAKALALAN
TSM	TAOS
CNY	MOAB
AKF	KUFRAH
MWA	MARION
TMC	TAMBOLAKA
AUI	AUA ISLAND
KMS	KUMASI
ZUC	IGNACE
YYD	SMITHERS
SBH	SAINT BARTHELEMY
SZY	SZCZYTNO / SZYMANY
JGB	JAGDALPUR
KRT	KHARTOUM
LSY	LISMORE
GEO	GEORGETOWN
KGL	KIGALI
ILG	WILMINGTON
KAA	KASAMA
GLO	GLOUCESTER
CSX	CHANGSHA
ORY	PARIS ORLY APT
GSR	GARDO
RUT	RUTLAND
DLL	DILLON
VLL	VALLADOLID
DER	DERIM
TCI	TENERIFE
NGD	ANEGADA
MXE	MAXTON
RIN	RINGI COVE
MRM	MANARE
ILO	ILOILO
UMD	UUMMANNAQ
KKU	EKUK
LSZ	MALI LOSINJ
GAD	GADSDEN
JBC	BOSTON
YCQ	CHETWYND
EFD	HOUSTON ELLINGTON
OHD	OHRID
NDB	NOUADHIBOU
JRH	JORHAT
GDP	GUADALUPE
MWH	MOSES LAKE
BRK	BOURKE
IFN	ISFAHAN
SVW	SPARREVOHN
HEK	HEIHE
SRM	SANDRINGHAM
SCF	PHOENIX SCOTTSDALE
LQN	QALA-NAU
YGG	GANGES HARBOR
VAK	CHEVAK
VDR	VILLA DOLORES
ILI	ILIAMNA
SAO	SAO PAULO
YHN	HORNEPAYNE
NLA	NDOLA
KKD	KOKODA
LMP	LAMPEDUSA
XMH	MANIHI
MGX	MOABI
LUX	LUXEMBOURG
MWQ	MAGWE
GPI	GUAPI
GPA	PATRAS
NWT	NOWATA
JSM	JOSE DE SAN MARTIN
IKO	NIKOLSKI
OMD	ORANJEMUND
RRK	ROURKELA
CJU	CHEJU
MNR	MONGU
BAF	Barnes Airport
LOD	LONGANA
GQQ	GALION
AUQ	ATUONA
NLO	KINSHASA
POZ	POZNAN / LAWICA
PID	NASSAU PARADISE ISLAND
YFX	FOX HARBOUR (ST. LEWIS)
BSJ	BAIRNSDALE
NCA	NORTH CAICOS
IXD	ALLAHABAD
VLM	VILLAMONTES
MST	MAASTRICHT
YNL	POINTS NORTH LANDING
SOM	SAN TOME
BIU	BILDUDALUR
BUN	BUENAVENTURA
GTT	GEORGETOWN
BHS	BATHURST
NLF	DARNLEY ISLAND
OAX	OAXACA
UNI	UNION ISLAND
RTM	ROTTERDAM
CMF	CHAMBERY
SMC	SANTA MARIA
WRL	WORLAND
TWH	CATALINA ISLAND
MVR	MAROUA
KOH	KOOLATAH
LJU	LJUBLJANA
MAM	MATAMOROS
ITM	OSAKA
SBF	SARDEH BAND
JCK	JULIA CREEK
YBB	PELLY BAY TOWNSITE/KUGAARUK
AWB	AWABA
BRQ	BRNO
XCM	CHATHAM
YFR	FORT RESOLUTION
NKI	NAUKITI
BBM	BATTAMBANG
FHZ	FAKAHINA
KLX	KALAMATA
JMY	FREETOWN
CME	CIUDAD DEL CARMEN
YSN	SALMON ARM
NUL	NULATO
YHR	HARRINGTON HARBOUR
YSG	SNOWDRIFT
MVA	MYVATN
GBM	GARBAHAREY
OKA	OKINAWA
ZRM	SARMI
JMM	MALMO HARBOUR
CYF	CHEFORNAK
YRI	riviere-du-loup
AXM	ARMENIA
SKZ	SUKKUR
SSA	SALVADOR
YZF	YELLOWKNIFE
GRV	GROZNYJ
BAA	BIALLA
BRE	BREMEN
GKL	GREAT KEPPEL ISLAND
SYU	WARRABER ISLAND
KCZ	KOCHI
YTM	Mont Tremblant
BCD	BACOLOD
BGA	BUCARAMANGA
TWA	TWIN HILLS
KUM	YAKUSHIMA
PHJ	PORT HUNTER
LAF	LAFAYETTE
WAG	WANGANUI
YPO	PEAWANUCK
YDA	DAWSON CITY
DLK	DULKANINNA
GXQ	COYHAIQUE
MCK	MCCOOK
TOF	TOMSK
GFL	GLENS FALLS
YQQ	COMOX
FEG	FERGANA
IOK	IOKEA
ZCL	ZACATECAS
BGS	BIG SPRING
COS	COLORADO SPRINGS
DLD	GEILO
BTV	BURLINGTON
YZX	GREENWOOD, NOVA SCOTIA
YCF	CORTES BAY
DCA	WASHINGTON NATIONAL APT
YMG	MANITOUWADGE
NAP	NAPLES
KHG	KASHI
AXR	ARUTUA
YGW	KUUJJUARAPIK
BLR	BANGALORE
CWS	CENTER ISLAND
MJF	MOSJOEN
CWT	COWRA
BDT	GBADOLITE
HTB	TERRE-DE-BAS
KHT	KHOST
VNO	VILNIUS
KBC	BIRCH CREEK
OKB	ORCHID BEACH
SHI	SHIMOJISHIMA
BOX	BORROLOOLA
CBG	CAMBRIDGE
REA	REAO
MOD	MODESTO
GEC	GECITKALE
RKI	ROKOT
ENE	ENDE
BGI	BARBADOS
EGC	BERGERAC
ADK	ADAK ISLAND
UTE	BUTTERWORTH
YHM	HAMILTON
KIX	OSAKA
HER	HERAKLION
IGU	IGUASSU FALLS
RON	RONDON
RJA	RAJAHMUNDRY
CZN	CHISANA
WGA	WAGGA WAGGA
ILE	KILLEEN
KTG	KETAPANG
HAC	HACHIJOJIMA
CCG	CRANE
OIM	OSHIMA
LPM	LAMAP
RJK	RIJEKA
TKS	TOKUSHIMA
MRE	MARA LODGES
LED	ST. PETERSBURG PULKOVO APT
ELQ	GASSIM
KBL	KABUL
HII	LAKE HAVASU CITY
BQS	BLAGOVESCHENSK
ZRF	ROCKFORD
BND	BANDAR ABBAS
PCC	PUERTO RICO
CSB	CARANSEBES
KMF	KAMINA
FAY	FAYETTEVILLE
DUS	DUSSELDORF
BFC	BLOOMFIELD
MSY	NEW ORLEANS
BYQ	BUNYU
KBM	KABWUM
CYO	CAYO LARGO DEL SUR
MFU	MFUWE
EDF	ANCHORAGE
YXL	SIOUX LOOKOUT
BAH	BAHRAIN
TAM	TAMPICO
XXX	MTCE PLANNING DUMMY CITY
FIH	KINSHASA
YEV	INUVIK
CUY	CUE
MEZ	MESSINA
LIJ	LONG ISLAND
FEN	FERNANDO DE NORONHA
SOG	SOGNDAL
KYK	KARLUK
GAW	GANGAW
KGC	KINGSCOTE
PBI	WEST PALM BEACH
YXR	EARLTON
PGF	PERPIGNAN
WBE	BEALANANA
LSW	LHOK SEUMAWE
YCB	CAMBRIDGE BAY
PEM	PUERTO MALDONADO
GFO	BARTICA
PTG	PIETERSBURG
BPS	PORTO SEGURO
HOI	HAO ISLAND
LMD	LOS MENUCOS
COR	CORDOBA
BHQ	BROKEN HILL
EVV	EVANSVILLE
PBO	PARABURDOO
LHE	LAHORE
RDM	REDMOND
ACC	ACCRA
LMM	LOS MOCHIS
TLD	TULI LODGE
CYS	CHEYENNE
FSC	FIGARI
FNT	FLINT
BJC	JEFFCO
MTC	MOUNT CLEMENS
CHP	CIRCLE HOT SPRINGS
UUU	MANUMU
CHX	CHANGUINOLA
DAR	DAR-ES-SALAAM
TEB	TETERBORO
YYB	NORTH BAY
TEF	TELFER
DDG	DANDONG
CZA	CHICHEN ITZA
MLG	MALANG
HNH	HOONAH
SPL	AMSTERDAM
AIY	ATLANTIC CITY
AUP	AGAUN
SOI	SOUTH MOLLE ISLAND
RTI	ROTI
EMX	EL MAITEN
CPS	ST. LOUIS DOWNTOWN AIRPT
BQE	BUBAQUE
YQC	QUAQTAQ
LIT	LITTLE ROCK
LTK	LATAKIA
JRK	ARSUK
BFX	BAFOUSSAM
ORF	NORFOLK
MWE	MEROWE
MHT	MANCHESTER
WVK	MANAKARA
MDL	MANDALAY
SCK	STOCKTON
TAH	TANNA
WBM	WAPENAMANDA
ROH	ROBINHOOD
BCN	BARCELONA
JDZ	JINGDEZHEN
BZG	BYDGOSZCZ / SZWEDEROWO
BVE	BRIVE-LA-GAILLARDE
FMO	MUNSTER
YCO	COPPERMINE/KUGLUKTUK
BKY	BUKAVU
KRP	KARUP
KRU	KERAU
KNE	KANAINJ
POR	PORI
DGA	DANGRIGA
TKG	BANDAR LAMPUNG
BYC	YACUIBA
MOW	MOSCOW
STM	SANTAREM
KTN	KETCHIKAN
VCD	VICTORIA RIVER DOWNS
YGR	ILES DE LA MADELEINE
CMP	SANTANA DO ARAGUAIA
SPN	SAIPAN
YNA	NATASHQUAN
FSP	SAINT PIERRE
NLE	NILES
KTM	KATHMANDU
BES	BREST
TIZ	TARI
KTD	KITADAITO
ZNU	NAMU
PZA	PAZ DE ARIPORO
AET	ALLAKAKET
AKX	AKTYUBINSK
DRB	DERBY
BIA	BASTIA
UEL	QUELIMANE
COE	COEUR D'ALENE
EDM	LA ROCHE SUR YON
CGA	CRAIG
UTH	UDON THANI
NIX	NIORO
SZX	SHENZHEN
GPN	GARDEN POINT
BMA	STOCKHOLM BROMMA APT
PAD	PADERBORN
HNA	MORIOKA
TMH	TANAHMERAH
INU	NAURU ISLAND
REP	SIEM REAP
KJA	KRASNOYARSK
VNG	VIENGXAY
IMI	INE ISLAND
TGZ	TUXTLA GUTIERREZ
RBS	ORBOST
VLD	VALDOSTA
DAC	DHAKA
NGC	GRAND CANYON NORTH RIM
TIM	TEMBAGAPURA
BRU	BRUSSELS
YVR	VANCOUVER
VIZ	VIZAG
LCK	COLUMBUS RICKENBACKER
LDK	LIDKOPING
YSU	SUMMERSIDE
CLT	CHARLOTTE
KNW	NEW STUYAHOK
ORW	ORMARA
SLC	SALT LAKE CITY
TYO	TOKYO
BOC	BOCAS DEL TORO
LKE	SEATTLE LAKE
TPP	TARAPOTO
ALM	ALAMOGORDO
DIJ	DIJON
SOV	SELDOVIA
WAH	WAHPETON
KAX	KALBARRI
GWO	GREENWOOD
BAP	BAIBARA
HLN	HELENA
IPN	IPATINGA
PZO	PUERTO ORDAZ
GLA	GLASGOW
NRK	NORRKOPING
DBO	DUBBO
HLP	JAKARTA HALIM PERDANA KUSUMA
WAA	WALES
PNR	POINTE NOIRE
SNI	SINOE
SHK	SEHONGHONG
GCM	GRAND CAYMAN
WRG	WRANGELL
TSL	TAMUIN
RUR	RURUTU
INX	INANWATAN
FAV	FAKARAVA
BKK	BANGKOK
OUH	OUDTSHOORN
YRN	RIVER'S INLET
ENA	KENAI
BGK	BIG CREEK
YHY	HAY RIVER
ZNA	NANAIMO
SCJ	SMITH COVE
KBR	KOTA BHARU
BRL	BURLINGTON
RUN	SAINT DENIS DE LA REUNION
MTK	MAKIN ISLAND
ABF	ABAIANG
MVW	MOUNT VERNON
FNE	FANE
LPY	LE PUY
MRZ	MOREE
AWD	ANIWA
UCA	UTICA
CAX	CARLISLE
ABQ	ALBUQUERQUE
SOU	SOUTHAMPTON
ACT	WACO
DSK	DERA ISMAIL KHAN
UIB	QUIBDO
EBB	ENTEBBE/KAMPALA
XMS	MACAS
HEI	HEIDE/BUESUM
MHQ	MARIEHAMN
DHM	DHARAMSHALA
LCI	LACONIA
SHL	SHILLONG
ERH	ERRACHIDIA
MLY	MANLEY HOT SPRINGS
CYB	CAYMAN BRAC
KLZ	KLEINZEE
KAQ	KAMULAI
BET	BETHEL
YZD	TORONTO, downsview airport
GLX	GALELA
ZFM	FORT MCPHERSON
PHF	NEWPORT NEWS
HVN	NEW HAVEN
MEP	MERSING
ENT	ENIWETOK ISLAND
MIJ	MILI ISLAND
AKB	ATKA
YLE	LAC LA MARTRE
AAL	AALBORG
EGV	EAGLE RIVER
RDB	RED DOG
DWB	SOALALA
DLH	DULUTH/SUPERIOR
CEZ	CORTEZ
LIW	LOIKAW
MXY	MCCARTHY
MDW	CHICAGO MIDWAY AIRPORT
SFG	SAINT MARTIN
SOP	SOUTHERN PINES
ZGR	LITTLE GRAND RAPIDS
SGC	SURGUT
MXM	MOROMBE
DBQ	DUBUQUE
TCU	THABA NCHU
LDU	LAHAD DATU
KOT	KOTLIK
GUM	GUAM
ACH	ALTENRHEIN
YWJ	FORT FRANKLIN
KYA	KONYA
GUD	GOUNDAM
HWN	HWANGE NATIONAL PARK
MSZ	NAMIBE
KGB	KONGE
CPX	CULEBRA
MVY	MARTHA'S VINEYARD
AKP	ANAKTUVUK PASS
RDT	RICHARD TOLL
JIW	JIWANI
PRM	PORTIMAO
CCU	CALCUTTA
KYE	TRIPOLI
SXU	SODDU
CGX	CHICAGO MEIGS FIELD
ZAD	ZADAR
RSS	ROSEIRES
FAI	FAIRBANKS
PYB	JEYPORE
ARW	ARAD
SUM	SUMTER
LAS	LAS VEGAS
CRP	CORPUS CHRISTI
IXI	LILABARI
JNN	NANORTALIK
THF	BERLIN TEMPELHOF APT
PFB	PASSO FUNDO
KGA	KANANGA
YYN	SWIFT CURRENT
USL	USELESS LOOP
POD	PODOR
TNN	TAINAN
SCX	SALINA CRUZ
SWY	SITIAWAN
YYF	PENTICTON
FNA	FREETOWN
BUL	BULOLO
GBJ	MARIE GALANTE
AIU	ATIU ISLAND
OMG	OMEGA
RYK	RAHIM YAR KHAN
FLO	FLORENCE
MAD	MADRID
KUL	KUALA LUMPUR
WMH	MOUNTAIN HOME
PET	PELOTAS
ASI	GEORGETOWN
SYY	STORNOWAY
ONG	MORNINGTON ISLAND
MAJ	MAJURO
BUZ	BUSHEHR
HLH	ULANHOT
SIL	SILA
YSC	SHERBROOKE,  QUEBEC
LBA	LEEDS/BRADFORD
RIJ	RIOJA
AIM	AILUK ISLAND
MED	MADINAH
MGB	MOUNT GAMBIER
DNK	DNEPROPETROVSK
ORV	NOORVIK
BOJ	BOURGAS
USM	KOH SAMUI
BZU	BUTA
SVU	SAVUSAVU
BTI	BARTER ISLAND
ANG	ANGOULEME
JHB	JOHOR BAHRU
KEQ	KEBAR
PIZ	POINT LAY
YDX	DOC CREEK
BEB	BENBECULA
APW	APIA
RAK	MARRAKECH
KOE	KUPANG
VIX	VITORIA
NKY	NKAYI
BCI	BARCALDINE
PPD	HUMACAO PALMAS DEL MAR
SBE	SUABI
NDJ	NDJAMENA
GAU	GUWAHATI
NRA	NARRANDERA
TLM	TLEMCEN
KYU	KOYUKUK
IAG	NIAGARA FALLS
DMM	DAMMAM KING FAHD INT ARPT
GPO	GENERAL PICO
CVF	COURCHEVEL
MZO	MANZANILLO
LXR	LUXOR
WMO	WHITE MOUNTAIN
ARD	ALOR ISLAND
NQU	NUQUI
AGJ	AGUNI
WAO	WABO
NEK	NEKEMT
FNJ	PYONGYANG
ZMM	ZAMORA
PWI	BELES
MME	TEESSIDE
SKR	SHAKISO
CUU	CHIHUAHUA
KHI	KARACHI
SDT	SAIDU SHARIF
LYB	LITTLE CAYMAN
BDR	BRIDGEPORT
BZZ	BRIZE NORTON
BTR	BATON ROUGE
ION	IMPFONDO
GBE	GABORONE
CNL	SINDAL
HLT	HAMILTON
DNM	DENHAM
CLZ	CALABOZO
GIG	RIO DE JANEIRO
HGH	HANGZHOU
ZNC	NYAC
JNI	JUNIN
SQI	STERLING
SNE	SAO NICOLAU
PHE	PORT HEDLAND
OAM	OAMARU
YGL	LA GRANDE
CGD	CHANGDE
RJH	RAJSHAHI
AKA	ANKANG
KIT	KITHIRA
LJA	LODJA
MBA	MOMBASA
KFP	FALSE PASS
AIB	ANITA BAY
CMJ	CHI MEI
CDL	CANDLE
WYN	WYNDHAM
EMK	EMMONAK
FLS	FLINDERS ISLAND
IDA	IDAHO FALLS
ZWS	STUTTGART
SDA	BAGHDAD
FMI	KALEMIE
SGV	SIERRA GRANDE
BPT	BEAUMONT
EFG	EFOGI
AKK	AKHIOK
PIE	ST PETERSBURG/CLEARWATER INT
YEG	EDMONTON INTERNATIONAL
HGU	MOUNT HAGEN
SNO	SAKON NAKHON
MUH	MERSA MATRUH
LPK	LIPETSK
ABX	ALBURY
TOE	TOZEUR
BSD	BAOSHAN
CDV	CORDOVA
MDK	MBANDAKA
TIJ	TIJUANA
TUV	TUCUPITA
TSD	TSHIPISE
SXL	SLIGO
AKQ	ASTRAKSETRA
DUE	DUNDO
SLA	SALTA
JGQ	HOUSTON TRANSCO TOWER GALLERIA
LOF	LOEN
BRC	SAN CARLOS DE BARILOCHE
PLN	PELLSTON
CWF	CHENNAULT INT'L. LAKE CHARLES
KKR	KAUKURA ATOLL
VVB	MAHANORO
VYS	PERU
KPE	YAPSIEI
GLS	GALVESTON
MHX	MANIHIKI ISLAND
VGZ	MOCOA
BOH	BOURNEMOUTH
TBZ	TABRIZ
ALP	ALEPPO
RTG	RUTENG
CTC	CATAMARCA
SVA	SAVOONGA
TET	TETE
CPR	CASPER
ERC	ERZINCAN
ORL	ORLANDO
NLP	NELSPRUIT
NYK	NANYUKI
HGR	HAGERSTOWN
FUE	FUERTEVENTURA
AZS	Samana El Catey International
BSB	BRASILIA
GLH	GREENVILLE
LUV	LANGGUR
TRZ	TIRUCHIRAPALLY
BZN	BOZEMAN
STW	STAVROPOL
FRK	FREGATE ISLAND
LCH	LAKE CHARLES
MCP	MACAPA
TIR	TIRUPATI
PCA	PORTAGE CREEK
VAT	VATOMANDRY
GLQ	GLENALLEN
PRJ	CAPRI
OLU	COLUMBUS
SVQ	SEVILLE
SKV	SANTA KATARINA
VDZ	VALDEZ
CCN	CHAKCHARAN
FBD	FAIZABAD
FUT	FUTUNA
MLM	MORELIA
KGS	KOS
YUX	HALL BEACH
MCH	MACHALA
PUQ	PUNTA ARENAS
MYZ	MONKEY BAY
GSP	GREENVILLE
XBR	BROCKVILLE
CKS	CARAJAS
JCA	CANNES
MNI	MONTSERRAT
GNB	GRENOBLE
VGS	GENERAL VILLEGAS
BTL	BATTLE CREEK
SQC	SOUTHERN CROSS
SYN	SEIYUN
MKH	MOKHOTLONG
TKP	TAKAPOTO
WUV	WUVULU ISLAND
RHE	REIMS
BWN	BANDAR SERI BEGAWAN
LPD	LA PEDRERA
PMD	PALMDALE
BSR	BASRA
BIB	BAIDOA
YNS	NEMISCAU
CJA	CAJAMARCA
XAP	CHAPECO
OLH	OLD HARBOR
AYW	AYAWASI
FRO	FLORO
IZM	IZMIR
NYC	NEW YORK
TID	TIARET
KBI	KRIBI
PCH	PALACIOS
IXG	BELGAUM
BHG	BRUS LAGUNA
JGR	GRONNEDAL
CCO	CARIMAGUA
RAF	RAS AN NAQB
SUJ	SATU MARE
YQS	SAINT THOMAS
FIN	FINSCHHAFEN
RFN	RAUFARHOFN
HAH	MORONI
ANH	ANUHA ISLAND RESORT
AIN	WAINWRIGHT
MDU	MENDI
TOB	TOBRUK
SUZ	SURIA
YRL	RED LAKE
LIR	DANIEL ODUBER QUIROS INTL
BYA	BOUNDARY
GBD	GREAT BEND
GEL	SANTO ANGELO
MBI	MBEYA
YOO	OSHAWA
MYB	MAYOUMBA
CAM	CAMIRI
KEF	REYKJAVIK
PSG	PETERSBURG
IEV	KIEV
SSE	SHOLAPUR
KWE	GUIYANG
YXY	WHITEHORSE
PFJ	PATREKSFJORDUR
XIN	XINGNING
DTA	DELTA
ZMR	MERANO
GWY	GALWAY
TBA	TABIBUGA
XTL	TADOULE LAKE
WIU	WITU
AGV	ACARIGUA
SDE	SANTIAGO DEL ESTERO
ILP	ILE DES PINS
DEM	DEMBIDOLLO
SEO	SEGUELA
CVT	COVENTRY
BEH	BENTON HARBOR
GLF	GOLFITO
MMB	MEMAMBETSU
SDX	SEDONA
MZK	MARAKEI
NIK	NIOKOLO KOBA
LCQ	Lake City Municipal, Florida
GYR	Goodyear   (Litchfield)
HAU	HAUGESUND
MYJ	MATSUYAMA
TDG	TANDAG
PMW	PALMAS
TEP	TEPTEP
JNU	JUNEAU
TOZ	TOUBA
PGM	PORT GRAHAM
YCS	CHESTERFIELD INLET
PVD	PROVIDENCE
CHT	CHATHAM ISLAND
XGA	GAOUA
CCC	CAYO COCO
YXN	WHALE COVE
ASG	ASHBURTON
BDD	BADU ISLAND
VNR	VANROOK
XPP	POPLAR RIVER
CAD	CADILLAC
WFK	FRENCHVILLE
CIF	CHIFENG
TWT	TAWITAWI
RAE	ARAR
OUA	OUAGADOUGOU
MRS	MARSEILLE
SVO	MOSCOW SHEREMETYEVO APT
ALU	ALULA
JHS	HOLSTEINSBORG
FDH	FRIEDRICHSHAFEN
KTU	KOTA
MYX	MENYAMYA
UDI	UBERLANDIA
GIL	GILGIT
LKO	LUCKNOW
DSI	DESTIN
YEC	YECHON
TNG	TANGIER
MTL	MAITLAND
SGY	SKAGWAY
SWG	SATWAG
SMK	SAINT MICHAEL
BUD	BUDAPEST
YNE	NORWAY HOUSE
TKE	TENAKEE
BKO	BAMAKO
SUX	SIOUX CITY
MGF	MARINGA
MPM	MAPUTO
CAS	CASABLANCA
TJS	TANJUNG SELOR
POT	PORT ANTONIO
LPB	LA PAZ
VIJ	VIRGIN GORDA
BSZ	BARTLETTS
GYI	GISENYI
CJC	CALAMA
QER	SHEHR
PZU	PORT SUDAN
KKI	AKIACHAK
KWP	WEST POINT
HKY	HICKORY
PLD	PLAYA SAMARA
MAS	MANUS ISLAND
BRS	BRISTOL
LXW	LUXHAFEN
FPR	FORT PIERCE
MMM	MIDDLEMOUNT
SLP	SAN LUIS POTOSI
KMJ	KUMAMOTO
SJY	SEINAJOKI
DBA	DALBANDIN
JHE	HELSINGBORG
SPC	SANTA CRUZ DE LA PALMA
SVG	STAVANGER
CYC	CAYE CHAPEL
XQP	QUEPOS
BEG	BELGRADE
BSC	BAHIA SOLANO
KIP	WICHITA FALLS
PGZ	PONTA GROSSA
PKP	PUKA PUKA
NGA	YOUNG
TBU	TONGATAPU
TRE	TIREE
KKC	KHON KAEN
CZU	COROZAL
LRE	LONGREACH
OXR	OXNARD/VENTURA
PAT	PATNA
RGI	RANGIROA ISLAND
CLD	CARLSBAD
KKH	KONGIGANAK
HOA	HOLA
LUG	LUGANO
LUP	KALAUPAPA
YAG	FORT FRANCES
GGG	LONGVIEW
BBO	BERBERA
GEV	GALLIVARE
GAY	GAYA
AIT	AITUTAKI
MKJ	MAKOUA
BJX	LEON-GUANAJUATO
MJB	MEJIT ISLAND
AGN	ANGOON
MIM	MERIMBULA
JCH	CHRISTIANSHAAB
SEA	SEATTLE
DAD	DA NANG
WST	WESTERLY
CRA	CRAIOVA
ISC	ISLES OF SCILLY
MBC	M'BIGOU
OKJ	OKAYAMA
KEX	KANABEA
RCB	RICHARDS BAY
BCO	JINKA
LAR	LARAMIE
HRK	KHARKOV
IXH	KAILASHAHAR
MUE	KAMUELA
CAZ	COBAR
NNB	SANTA ANA ISLAND
PAB	BILASPUR
CAJ	CANAIMA
CMD	COOTAMUNDRA
CUP	CARUPANO
ONI	MOANAMANI
TFS	TENERIFE
MYD	MALINDI
LBH	SYDNEY PALM BEACH
AUH	ABU DHABI
AAY	AL GHAYDAH
ZSW	PRINCE RUPERT SEAL COVE
CZP	CAPE POLE
HRO	HARRISON
SHO	SOKCH'O
GTR	COLUMBUS GOLDEN TRIANGLE REGIO
DCF	DOMINICA CANE FIELD
WFI	FIANARANTSOA
AGR	AGRA
OKP	OKSAPMIN
DLO	DOLOMI
AZB	AMAZON BAY
CTN	COOKTOWN
SHC	INDASELASSIE
GYN	GOIANIA
CIW	CANOUAN ISLAND
OCJ	OCHO RIOS
KYS	KAYES
JKH	CHIOS
MDC	MANADO
LOY	LOYANGALANI
MCA	MACENTA
SAK	SAUDARKROKUR
GBZ	GREAT BARRIER ISLAND
MTS	MANZINI
MHD	MASHAD
BFS	BELFAST
GSA	LONG PASIA
OBO	OBIHIRO
KRE	KIRUNDO
YQF	RED DEER
HIN	CHINJU
ZQN	QUEENSTOWN
SIG	SAN JUAN ISLA GRANDE
OSH	OSHKOSH
CTA	CATANIA
NKN	NANKINA
HMA	MALMO CITY
TGJ	TIGA
TSV	TOWNSVILLE
YTB	HARTLEY BAY
RVE	SARAVENA
FOC	FUZHOU
SBR	SAIBAI ISLAND
ENS	ENSCHEDE
OCH	NACOGDOCHES
LBQ	LAMBARENE
KIJ	NIIGATA
ASK	YAMOUSSOUKRO
IRC	CIRCLE
NYI	SUNYANI
AVN	AVIGNON
SXQ	SOLDOTNA
TUO	TAUPO
RGE	PORGERA
GRW	GRACIOSA ISLAND
ZAZ	ZARAGOZA
YMI	MINAKI
YBF	BAMFIELD
QZF	FONT REMEU
NBB	BARRANCOMINAS
PQI	PRESQUE ISLE
PBC	PUEBLA
IHU	IHU
KIS	KISUMU
AEY	AKUREYRI
ELT	TOUR SINAI
MJE	MAJKIN
CED	CEDUNA
YQA	MUSKOKA
VAS	SIVAS
GNE	GHENT
RMA	ROMA
BFO	BUFFALO RANGE
SSX	SAMSUN
MTF	MIZAN TEFERI
KLR	KALMAR
IRD	ISHURDI
SMA	SANTA MARIA
LGW	LONDON GATWICK APT
MMD	MINAMI DAITO
MBH	MARYBOROUGH
TED	THISTED
YKM	YAKIMA
YMO	MOOSONEE
BME	BROOME
URM	URIMAN
MQL	MILDURA
EEK	EEK
KUO	KUOPIO
UVL	NEW VALLEY
BIQ	BIARRITZ
TKX	TAKAROA
LAT	LA URIBE
TNI	SATNA
EOH	MEDELLIN
ILA	ILLAGA
MNL	MANILA
CUN	CANCUN
ALG	ALGIERS
SLQ	SLEETMUTE
SML	STELLA MARIS
SMY	SIMENTI
RIS	RISHIRI
FRW	FRANCISTOWN
MOT	MINOT
OBC	OBOCK
ROS	ROSARIO
RIF	RICHFIELD
TMS	SAO TOME
MVB	FRANCEVILLE
MJT	MYTILENE
HVG	HONNINGSVAG
YDE	PARADISE RIVER
MEB	MELBOURNE
MFF	MOANDA
KRS	KRISTIANSAND / KJEVIK
BZD	BALRANALD
QDU	DUSSELDORF
GOC	GORA
MHE	MITCHELL
DJJ	JAYAPURA
MPW	MARIUPOL
LCL	LA COLOMA
LWT	LEWISTOWN
YTT	TISDALE
USI	MABARUMA
SKD	SAMARKAND
UNK	UNALAKLEET
PMT	PARAMAKATOI
NAH	NAHA
PHB	PARNAIBA
CHH	CHACHAPOYAS
MGT	MILLINGIMBI
OKK	KOKOMO
XMY	YAM ISLAND
RCM	RICHMOND
CVM	CIUDAD VICTORIA
SPH	SOPU
RST	ROCHESTER
JEJ	JEH
CSY	CHEBOKSARY
CBL	CIUDAD BOLIVAR
LWS	LEWISTON
INQ	INISHEER
BCM	BACAU
ZAJ	ZARANJ
FYU	FORT YUKON
LIL	LILLE
ODN	LONG SERIDAN
SAH	SANAA
DGL	DOUGLAS
ISH	ISCHIA
ASV	AMBOSELI
SYR	SYRACUSE
VOH	VOHEMAR
CMR	COLMAR
MQN	MO I RANA
EKO	ELKO
AMO	MAO
IVC	INVERCARGILL
BTK	BRATSK
LAD	LUANDA
TMR	TAMANRASSET
EBJ	ESBJERG
ZKE	KASCHECHEWAN
UMR	WOOMERA
JSL	ATLANTIC CITY
EWI	ENAROTALI
BWI	BALTIMORE
CWB	CURITIBA
ROT	ROTORUA
PDU	PAYSANDU
EIA	EIA
TUC	TUCUMAN
PCN	PICTON
TAB	TOBAGO
GOP	GORAKHPUR
RES	RESISTENCIA
DDN	DELTA DOWNS
NGO	NAGOYA
YHG	CHARLOTTETOWN
MGD	MAGDALENA
AVI	CIEGO DE AVILA
EMS	EMBESSA
CGB	CUIABA
TFF	TEFE
VCV	GEORGE AFB, VICTORVILLE, CA
GFN	GRAFTON
SNB	SNAKE BAY
GOO	GOONDIWINDI
SJC	SAN JOSE,  CALIFORNIA
ADQ	KODIAK
SXP	SHELDONS POINT
PER	PERTH
GDE	GODE
BAJ	BALI
RKU	YULE ISLAND
BEJ	BERAU
HNS	HAINES
CHA	CHATTANOOGA
IXU	AURANGABAD
YDQ	DAWSON CREEK
KTO	KATO
RWI	ROCKY MOUNT
FGU	FANGATAU
MGR	MOULTRIE
GEA	NOUMEA
MFJ	MOALA
BPB	BORIDI
AWZ	AHWAZ
BAS	BALALAE
TMM	TAMATAVE
STD	SANTO DOMINGO
NAU	NAPUKA ISLAND
YVO	VAL D'OR
MMZ	MAIMANA
APO	APARTADO
VAF	VALENCE
BBI	BHUBANESWAR
TAE	TAEGU
WZY	NASSAU SPB
BRA	BARREIRAS
NCY	ANNECY
ULU	GULU
NYO	NYKOPING
PVY	POPE VANOY
BTN	BENNETTSVILLE
POW	PORTOROZ
MZP	MOTUEKA
BNY	BELLONA
FIC	FIRE COVE
KRF	KRAMFORS
FLA	FLORENCIA
LUH	LUDHIANA
VBV	VANUABALAVU
OBF	OBERPFAFFENHOFEN
LNK	LINCOLN
SXN	SUAPAN
TRD	TRONDHEIM
LTQ	LE TOUQUET
KUU	KULU
MMY	MIYAKO JIMA
KHS	KHASAB
MOZ	MOOREA
KZI	KOZANI
LVD	LIME VILLAGE
ESB	ANKARA
AKD	AKOLA
PDG	PADANG
SXI	SIRRI ISLAND
WOE	Woensdrecht Air Base
UBA	UBERABA
MNG	MANINGRIDA
SHV	SHREVEPORT
SXC	CATALINA ISLAND
VEJ	VEJLE
LIM	LIMA
BGC	BRAGANCA
YQI	YARMOUTH
DDI	DAYDREAM ISLAND
CXJ	CAXIAS DO SUL
NPO	NANGAPINOH
BWQ	BREWARRINA
SIQ	SINGKEP
IXL	LEH
DOM	DOMINICA
CAB	CABINDA
YYL	LYNN LAKE
HLF	HULTSFRED
ABJ	ABIDJAN
KXE	KLERKSDORP
HTR	HATERUMA
ZRJ	ROUND LAKE
MZQ	MKUZE
THB	THABA-TSEKA
BEA	BEREINA
KTV	KAMARATA
KAC	KAMESHLI
MSL	FLORENCE
TBO	TABORA
SCT	SOCOTRA
TEM	TEMORA
SIU	SIUNA
KCC	COFFMAN COVE
TSY	TASIKMALAYA
RHI	RHINELANDER
PAJ	PARACHINAR
HKT	PHUKET
IOM	ISLE OF MAN
CIB	CATALINA ISLAND
JED	JEDDAH
CUG	ORANGE CUDAL
KSD	KARLSTAD
CXB	COX'S BAZAR
FMN	FARMINGTON
NKV	NICHEN COVE
IRG	LOCKHART RIVER
LVB	LIVRAMENTO
RAQ	RAHA
CIJ	COBIJA
JCN	INCHEON
NSO	SCONE
BUC	BURKETOWN
SIP	SIMFEROPOL
XTG	THARGOMINDAH
KWF	WATERFALL
MFM	MACAU
TCL	TUSCALOOSA
HGO	KORHOGO
NVA	NEIVA
RAP	RAPID CITY
PDI	PINDIU
RSE	SYDNEY
TCA	TENNANT CREEK
ABE	ALLENTOWN/BETHLEHEM
NOC	CONNAUGHT
IAN	KIANA
NST	NAKHON SI THAMMARAT
PNY	PONDICHERRY
WMK	MEYERS CHUCK
LAZ	BOM JESUS DA LAPA
STR	STUTTGART APT
IBZ	IBIZA
TUG	TUGUEGARAO
SWN	SAHIWAL
ILF	ILFORD
NOA	NOWRA
EME	EMDEN
UTT	UMTATA
SBZ	SIBIU
HOQ	HOF
NAA	NARRABRI
YMN	MAKKOVIK
DGT	DUMAGUETE
REX	REYNOSA
KKA	KOYUK
MBQ	MBARARA
DBP	DEBEPARE
BBN	BARIO
NYU	NYAUNG-U
BGJ	BORGARFJORDUR EYSTRI
SGU	SAINT GEORGE
YPC	PAULATUK
OOL	GOLD COAST
TKQ	KIGOMA
AAV	ALAH
DOL	DEAUVILLE
OER	ORNSKOLDSVIK
SOQ	SORONG
FRL	FORLI
BBG	BUTARITARI
AKJ	ASAHIKAWA
LLN	KELILA
KHE	KHERSON
TLI	TOLITOLI
TWF	TWIN FALLS
AMI	MATARAM
WMX	WAMENA
KAB	KARIBA
EKN	ELKINS
DAY	DAYTON
MJJ	MOKI
SPK	SAPPORO
YYR	GOOSE BAY
DDP	DORADO
SMP	STOCKHOLM
GDX	MAGADAN
ONH	ONEONTA
ARV	MINOCQUA
BGF	BANGUI
IGN	ILIGAN
MRD	MERIDA
WNZ	WENZHOU
NAI	ANNAI
ASU	ASUNCION
RNB	RONNEBY
ABS	ABU SIMBEL
PMR	PALMERSTON NORTH
SPI	SPRINGFIELD
BZR	BEZIERS
WLS	WALLIS ISLAND
BCL	BARRA COLORADO
KBY	STREAKY BAY
SYO	SAKATASHI
UNG	KIUNGA
BXX	BORAMA
RXS	ROXAS
PIR	PIERRE
KET	KENGTUNG
SVC	SILVER CITY
ATP	AITAPE
EWO	EWO
CEM	CENTRAL
KCG	CHIGNIK
WAC	WACA
SAY	SIENA
MLI	MOLINE
USN	ULSAN
MSW	MASSAWA
BMB	BUMBA
DDC	DODGE CITY
CUC	CUCUTA
PCL	PUCALLPA
SIR	SION
SRN	STRAHAN
TTU	TETUAN
BAX	BARNAUL
MXZ	MEIXIAN
KAE	KAKE
CHD	CHANDLER
LNG	LESE
YAI	CHILLAN
TBG	TABUBIL
GSE	GOTHENBURG SAEVE APT
YKX	KIRKLAND LAKE
TIW	TACOMA
VKO	MOSCOW VNUKOVO APT
KEJ	KEMEROVO
ATT	ATMAUTLUAK
EJH	WEDJH
MGZ	MYEIK
ARZ	N'ZETO
PAR	PARIS
GDT	GRAND TURK
PUC	PRICE
HPH	HAIPHONG
FPO	FREEPORT
IEG	ZIELONA GORA / BABIMOST
SXH	SEHULEA
LPL	LIVERPOOL
UIR	QUIRINDI
AOI	ANCONA
SPQ	SAN PEDRO
OCF	OCALA
AQP	AREQUIPA
YGO	GODS NARROWS
CUQ	COEN
OKD	SAPPORO OKADAMA
VLN	VALENCIA
YQK	KENORA
SCM	SCAMMON BAY
ODE	ODENSE
PLO	PORT LINCOLN
TGD	TITOGRAD
SJI	SAN JOSE
TEZ	TEZPUR
MLU	MONROE
TLL	TALLINN
LEW	LEWISTON/AUBURN
KBU	KOTABARU
ALA	ALMA ATA
CPD	COOBER PEDY
AOO	ALTOONA
HCB	SHOAL COVE
NSB	BIMINI NORTH SPB
ALC	ALICANTE
CLL	COLLEGE STATION
KSM	SAINT MARY'S
YGN	GREENWAY SOUND
SKL	ISLE OF SKYE
DPL	DIPOLOG
MQI	QUINCY
VIT	VITORIA
EVE	EVENES
SRH	SARH
ELF	EL FASHER
FYV	FAYETTEVILLE
CIM	CIMITARRA
YUB	TUKTOYAKTUK
GUR	ALOTAU
BNM	BODINUMU
YWL	WILLIAMS LAKE
SFN	SANTA FE
NTL	NEWCASTLE
WSA	WASUA
GRG	GARDEZ
TCH	TCHIBANGA
KCL	CHIGNIK
SOK	SEMONGKONG
ALH	ALBANY
HAK	HAIKOU
FMC	FIVE MILE
SJW	SHIJIAZHUANG
IHO	IHOSY
NDM	MENDI
KIB	IVANOF BAY
GZT	GAZIANTEP
VID	VIDIN
MUK	MAUKE ISLAND
NNT	NAN
RSJ	ROSARIO
TGE	TUSKEGEE
NSK	NORILSK
MID	MERIDA
BYK	BOUAKE
LWB	LEWISBURG
YXU	LONDON
YHU	MONTREAL (ST. HUBERT)
KRX	KAR KAR
MFD	MANSFIELD
KPS	KEMPSEY
NDZ	NORDHOLZ-SPIEKA
TME	TAME
KDN	N'DENDE
KPB	POINT BAKER
MNU	MAULMYINE
CDC	CEDAR CITY
SAC	SACRAMENTO
OCA	OCEAN REEF
FTW	DALLAS/FORT WORTH
EBD	EL OBEID
WTL	TUNTUTULIAK
KGF	KARAGANDA
RIX	RIGA
MLL	MARSHALL
TPR	MOUNT TOM PRICE
TMW	TAMWORTH
SGK	SANGAPI
PZE	PENZANCE
ZTJ	INTERLAKEN WEST
MEY	MEGHAULI
LDI	LINDI
AXU	AXUM
PNK	PONTIANAK
MJD	MOHENJODARO
YAO	YAOUNDE
DAL	DALLAS/FORT WORTH
MIR	MONASTIR
LSI	SHETLAND ISLANDS
OLA	ORLAND
JSY	SYROS ISLAND
LUA	LUKLA
SEH	SENGGEH
RKO	SIPORA
YVC	LA RONGE
SDJ	SENDAI
PDO	PENDOPO
DRW	DARWIN
OMN	OSMANABAD
MKP	MAKEMO
PKE	PARKES
PTK	PONTIAC
SGO	SAINT GEORGE
YHI	HOLMAN ISLAND
NWI	NORWICH
MWJ	MATTHEWS RIDGE
ERA	ERIGAVO
KEB	ENGLISH BAY
AJY	AGADES
YKD	KINCARDINE
BXB	BABO
YEK	ARVIAT  (ESKIMO POINT)
YUT	REPULSE BAY
HPA	HA'APAI
VNY	LOS ANGELES VAN NUYS APT
LAM	LOS ALAMOS
HVK	HOLMAVIK
MVZ	MASVINGO
TOS	TROMSO
OWB	OWENSBORO
BDL	HARTFORD BRADLEY
EMA	EAST MIDLANDS
MYT	MYITKYINA
PCP	PRINCIPE ISLAND
MKQ	MERAUKE
ABT	AL-BAHA
NME	NIGHTMUTE
BJS	BEIJING
BEP	BELLARY
NPH	NEPHI
FRU	FRUNZE
BUI	BOKONDINI
ESF	ALEXANDRIA
WSB	STEAMBOAT BAY
APL	NAMPULA
RAS	RASHT
SWO	STILLWATER
KUK	KASIGLUK
VVZ	ILLIZI
GAO	GUANTANAMO
TGM	TIRGU MURES
SFU	SAFIA
HEH	HEHO
URR	URRAO
LHR	LONDON HEATHROW APT
DNH	DUNHUANG
KGX	GRAYLING
PEW	PESHAWAR
SLE	SALEM
BHX	BIRMINGHAM
BHE	BLENHEIM
ATB	ATBARA
TLG	TULAGHI ISLAND
KAT	KAITAIA
MGW	MORGANTOWN
UUS	YUZHNO-SAKHALINSK
BCY	BULCHI
KYX	YALUMET
IHN	QISHN
BJO	BERMEJO
GOA	GENOA
OCE	OCEAN CITY
FOU	FOUGAMOU
VRB	VERO BEACH
NVK	NARVIK
BIS	BISMARCK
ZKB	KASABA BAY
ACE	LANZAROTE
HCR	HOLY CROSS
BYX	BANIYALA
ZEL	BELLA BELLA
GOQ	GOLMUD
YYG	CHARLOTTETOWN
SIA	XI'AN
LDH	LORD HOWE ISLAND
HVA	ANALALAVA
TUA	TULCAN
SJO	SAN JOSE, COSTA RICA
HYN	HUANGYAN
SLS	SILISTRA
AGL	WANIGELA
FAK	FALSE ISLAND
GJL	JIJEL
FBM	LUBUMBASHI
PIT	PITTSBURGH
WRA	WARDER
BUO	BURAO
ADA	ADANA
GUW	GURYEV
KIF	KINGFISHER LAKE
RGA	RIO GRANDE
BGX	BAGE
HBR	HOBART
STY	SALTO
PLU	BELO HORIZONTE
KRJ	KARAWARI
WAQ	ANTSALOVA
TAZ	TASHAUZ
KHJ	KAUHAJOKI
EIS	BEEF ISLAND
BLZ	BLANTYRE
LDC	LINDEMAN ISLAND
NAK	NAKHON RATCHASIMA
DUJ	DUBOIS
YRR	STUART ISLAND
SRO	SANTANA RAMOS
YGC	GRANDE CACHE
BXE	BAKEL
CZH	COROZAL
YRG	RIGOLET
MUX	MULTAN
IPH	IPOH
RRE	MARREE
LNO	LEONORA
VLV	VALERA
SAU	SAWU
RGH	BALURGHAT
SVP	KUITO
CEB	CEBU
JLN	JOPLIN
XYA	YANDINA
CGM	CAMIGUIN
INT	WINSTON-SALEM
YSP	MARATHON
YDS	DESOLATION SOUND
TOM	TOMBOUCTOU
CCK	KEELING
TUP	TUPELO
DNQ	DENILIQUIN
ANX	ANDENES
SPP	MENONGUE
ADE	ADEN
ELB	EL BANCO
EDR	EDWARD RIVER
HCW	CHERAW
